Instructions: 

Welcome to Hebe, my Interactive Fiction game! This game is set in Ancient Greece and you are the goddess of eternal youth, Hebe. If at any point you need help, type help into the console. Have fun and thank you for playing!

Hebe
An Interactive Fiction by Marina Diagourta
Release 1 / Serial number 240825 / Inform 7 v10.1.2 / D

The grand hall of Mount Olympus gleamed like a jewel in the Greek night sky. The lustrous surfaces of white marble and gold reflected the flickering torchlight. Columns of shimmering marble, capped with gilded Corinthian capitals, reached a vaulted ceiling adorned with intricate decorative paintings depicting scenes from the gods' legendary exploits. Among the hall's lavish embellishments were thrones of solid gold, masterfully crafted handwoven carpets and golden chandeliers, suspended from the ceiling. Today the gods were celebrating the ascension of Heracles to immortality, and also the anniversary of your marriage to him.

The air was thick with the aroma of ambrosia and the rich scent of a feast laid out for the celebrating gods. Plates piled high with the finest delicacies filled every corner of the vast chamber, while goblets brimming with nectar passed from hand to hand, by the ever-dutiful Ganymedes.

The hall was alive with the sounds of the festivities. Laughter and song echoed through the space as gods danced and sang in celebration. Nymphs twirled gracefully among them, their light steps barely disturbing the surface of the marble floor. In the center of the room, a troupe of performers reenacted the epic labors of Heracles, their movements grand and heroic, a fitting tribute to the hero whose deeds had won him a place among the gods.

At the heart of the celebration sat the honoured guests of the occasion, Heracles himself, with you, his wife, to his right. On Heracles' left sat Zeus, king of the gods, who is glancing upon you both full of pride. On your right sat Hera, her demeanor calm and gratified, with a rare softness in her gaze. She put aside any conflict during the event, given her affection for you.

The Twelve Olympians were all in attendance, their mighty forms gracing the hall with an air of majesty. They conversed among themselves, as they partook in the feast. Nymphs flitted among them, their laughter mingling with the conversations, adding a lightness to the evening's festivities.

Everywhere you looked, there was movement, life, and joy. The gods, unbound by the cares of the mortal world, indulged in the pleasures of the moment, their spirits lifted by the music, the food, and the company. The hall of Olympus had never shined brighter, a fitting tribute to the divine couple.

I beg your pardon?

>give club to heracles
(first taking the Heracles' Club)
You picked up a Heracles' Club.

He smiles to you. "Thank you my dearest."

>[enter]
Suddenly, an eerie silence fell over the festive night. The singing and dancing ceased, as if an unseen hand had stilled them. For a brief moment, you felt the coldness of the mountain air, a stark contrast to the pleasant breeze that had enveloped you moments before. A sense of foreboding fills you as you become aware that all eyes are turned behind you. You lock eyes with Heracles, both of you sharing a look of worry. With a growing sense of dread, you turned to see what had drawn everyone's attention.

"Oh dear, please, do not let my presence taint your insignificant gathering. Carry on as you were."

The voice was unmistakable, deep and resonant, carrying an ancient power that sent shivers down your spine. It was Kronos. So much time has passed since our triumph in the War of Titans- the Titanomachy. How did he manage to escape Tartarus?

The sight of the Titan, towering and menacing, shrouded in shadows, struck fear into the hearts of all present. You start to feel the ichor in your divine veins turn cold, as if time itself had frozen. The gods, normally so mighty and formidable, stand paralyzed in shock. Nothing moves. In a heartbeat, you break free from the daze and come to your senses. Your next actions have never been more certain. It's now or never.

You grab Heracle's club out of his hands and leap towards Kronos. Then you feel yourself slipping into unconciousness.

>[enter]
Garden of Hesperides

From here you can sail to: 
→ Piraeus
→ Sounio
→ Aulis
→ Paphos

You can see Eternal Chalice of Nectar, Aigle, Arethousa, Erytheia and Hesperie here.

>sail to aulis
You sail to the Port of Aulis.

Port of Aulis
From here you can sail to: 
→ Sounio
→ Garden of Hesperides

>w
Agora of Aulis

>s
Gates of Aulis
From here you can travel to: 
→ Thebes
→ Athens
→  Delphi
→ Ephyra
→ Mount Olympus

>travel to thebes
You travel to the Gates of Thebes.

Gates of Thebes
From here you can travel to: 
→ Athens
→ Aulis
→ Delphi
→ Ephyra
→ Mount Olympus

>n
Agora of Thebes

>u
You can't go that way.

>up
You can't go that way.

>go up
You can't go that way.

>n
Kadmea
You can see a walls here.

>e
You can't go that way.

>w
You can't go that way.

>s
Agora of Thebes

>enter palace of kadmus
You can't see any such thing.

>showme
Agora of Thebes - room
    yourself - woman
        Heracles' Club

>go in kadmes
You can't see any such thing.

>go in kadmea
You can't see any such thing.

* * *

I beg your pardon?

>help
Basic Commands

1. Movement Commands:

   • Go [direction]: Move to another room. Example: "go north", "go in" or "enter", "out".
   • Directions include: north, south, east, west, northeast, northwest, southeast, southwest, up, and down.
   • You can also use the shortcuts n, s, e, w, ne, nw, se, sw, u and d.

2. Interaction Commands:

   • Look: Examine your surroundings. Example: "look", "look around", "l".
   • Examine [object]: Inspect an item in detail. Example: "examine book", "x book".
   • Take [object]: Pick up an item. Example: "take key".
   • Drop [object]: Put down an item. Example: "drop book".
   • Put [object] on/in [object]: Put an item on top or inside another item. Example: "put flower in pot".
   • Open/Close [object]: Open or close something. Example: "open door", "close box".
   • Give [object] to [person]: Give an item to someone. Example: "give book to librarian".

3. Conversation Commands:

   • Talk to [person]: Initiate conversation. Example: "talk to librarian".
   • Ask [person] about [topic]: Ask someone about something specific. Example: "ask librarian about book".
   • Tell [person] about [topic]: Tell someone about a topic. Example: "tell librarian about secret".

4. Miscellaneous Commands:

   • Inventory: See what you're carrying. Example: "inventory", "i".
   • Wait: Pass time. Example: "wait".
   • Save/Restore/Quit: Manage your game. Example: "save", "restore", "quit".

5. Game-Specific Commands:

   • 

You can also combine commands with objects and people, such as "take book and give it to librarian".

>save
Ok.

>q
Are you sure you want to quit?

* * *

I beg your pardon?

>i
You are carrying nothing.

>e
You can't go that way.

>d
You wouldn't want to leave and miss any of the festivities!

>s
You can't go that way.

>n
You can't go that way.

>l
Mount Olympus Hall
You can see Heracles, Zeus, Hera, Demeter, Hestia, Poseidon, Aphrodite, Apollo, Artemis, Athena, Ares, Dionysus, Hephaestus and Hermes. Ganymedes is running around, serving nectar on request.

>i
You are carrying nothing.

>ask heracles about his club
Ah its over there

>give club to heracles
(first taking the Heracles' Club)
You picked up a Heracles' Club.

He smiles to you. "Thank you my dearest."

You give the Heracles' Club to the God Heracles.

>[enter]
Suddenly, an eerie silence fell over the festive night. The singing and dancing ceased, as if an unseen hand had stilled them. For a brief moment, you felt the coldness of the mountain air, a stark contrast to the pleasant breeze that had enveloped you moments before. A sense of foreboding fills you as you become aware that all eyes are turned behind you. You lock eyes with Heracles, both of you sharing a look of worry. With a growing sense of dread, you turned to see what had drawn everyone's attention.

"Oh dear, please, do not let my presence taint your insignificant gathering. Carry on as you were."

The voice was unmistakable, deep and resonant, carrying an ancient power that sent shivers down your spine. It was Kronos. So much time has passed since our triumph in the War of Titans- the Titanomachy. How did he manage to escape Tartarus?

The sight of the Titan, towering and menacing, shrouded in shadows, struck fear into the hearts of all present. You start to feel the ambrosia in your divine veins turn cold, as if time itself had frozen. The gods, normally so mighty and formidable, stand paralyzed in shock. Nothing moves. In a heartbeat, you break free from the daze and come to your senses. Your next actions have never been more certain. It's now or never.

You grab Heracle's club out of his hands and leap towards Kronos. Then you feel yourself slipping into unconciousness.

>[enter]
Garden of Hesperides
1-2 months timeskip. the nymphs tended to your wounds and restored you with nectar and ambrosia. They tell you what happened with the gods and send you towards the oracle of delphi.

From here you can sail to: 
→ Piraeus
→ Sounio
→ Aulis
→ Paphos

You can see Ambrosia, Aigle, Arethousa, Erytheia and Hesperie here.

>sail to aulis
You sail to the Port of Aulis.

Port of Aulis
From here you can sail to: 
→ Sounio
→ Garden of Hesperides

* * *

>w
Agora of Aulis

>n
You can't go that way.

>ne
You can't go that way.

>nw
You can't go that way.

>w
You can't go that way.

>s
Gates of Aulis
From here you can travel to: 
→ Thebes
→ Athens
→  Delphi
→ Ephyra
→ Mount Olympus

>travel to ephyra
You travel to the Gates of Ephyra.

Gates of Ephyra
From here you can travel to: 
→ Mount Olympus 
→ Athens
→ Thebes
→ Aulis
→ Delphi

>e
East of Ephyra
You can see a Charon's boat and Charon here.

>i
You are carrying:
  a Heracles' Club

* * *

I beg your pardon?

>l
Temple of the Aulidean Artemis
Inside the Temple of the Aulidean Artemis you can see a sundial, the statue of Artemis and her sacrificial altar.

>take altar
That's hardly portable.

>speak with altar
(to yourself)
There is no reply.

>x altar
The altar of Artemis.

>x offerings
You can't see any such thing.

>WHAT CAN I SEE
That's not a verb I recognise.

>i
You are carrying nothing.

>x sundial
You notice it has both sundial and moondial marks, so you can tell the time both with the help of the sun and the moon. You also see some words carved on its gnomon: At midday, let Apollo's light cast no shadow, and at midnight, let Artemis" glow guide the way. Only then shall the twins unveil the hidden path.

Judging by the gnomon's shadow and the sun markings, the time is ten past nine.

>wait until 11:59
It is one minute to twelve now.

>x sundial
The words carved on the gnomon read: At midday, let Apollo's light cast no shadow, and at midnight, let Artemis" glow guide the way. Only then shall the twins unveil the hidden path.

Judging by the gnomon's shadow and the sun markings, the time is twelve o'clock.

At twelve o'clock you hear the sound of the sun pocket opening.

>x sun pocket
The sun pocket is open.

>take sun key
You picked up a sun key.

>take moon key
Which do you mean, the moon lock or the moon pocket?

>take moon lock
That seems to be a part of the statue of artemis.

>take moon pocket
That seems to be a part of the sundial.

>take sundial
That's hardly portable.

>wait untill 23:57
I only understood you as far as wanting to wait.

>wait until 23:55
At ten past twelve you hear the sound of the sun pocket closing.

It is five to twelve now.

>x sundial
The words carved on the gnomon read: At midday, let Apollo's light cast no shadow, and at midnight, let Artemis" glow guide the way. Only then shall the twins unveil the hidden path.

Judging by the gnomon's shadow and the moon markings, the time is twelve o'clock.

>x moon pocket
The moon pocket is closed.

>wait until midnight
It is twelve o'clock now.

At twelve o'clock you hear the sound of the moon pocket opening.

>x moon pocket
The moon pocket is open.

>take moon key
You picked up a moon key.

>wait
Time passes.
Would you maybe prefer waiting until a certain time?

>disgusting
That's not a verb I recognise.

>l
Temple of the Aulidean Artemis
 You step into the sacred Temple of Aulidean Artemis, where the scent of incense and ancient prayers is still fresh, despite the absence of the priestesses. As you pass through the pronaos, your eyes are drawn to the moonlight cascading down from the open ceiling, illuminating an imposing sundial that stands ar the center of the chamber. The moon's rays trace their path across the dial, a silent testament to the passing hours in this eternal sanctuary.

Entering the naos, the very heart of the temple, you find yourself in the presence of the magnificent golden statue of Artemis. Your sister stands tall and proud, her form aglow with a divine radiance that speaks of her unyielding strength and purity. In her left hand, she holds the antlers of a noble deer, symbolizing her dominion over the wild, while her right hand grips her bow, ever ready to protect those who dwell under her watchful eye. A quiver, filled with finely crafted arrows, rests upon her back, the tools of the huntress who lets no prey escape.

At her feet, the altar of Artemis beckons, a place where mortals have laid their offerings, hoping to earn her favor.

>i
You are carrying:
  a moon key
  a sun key

>x moon key
The head of the key is shapped like a cresent moon. Its colour is a warm ivory.

>x sun key
The head of the key is shapped like a sun with curvy rays. Its colour is a bright gold.

>l
Temple of the Aulidean Artemis
 You step into the sacred Temple of Aulidean Artemis, where the scent of incense and ancient prayers is still fresh, despite the absence of the priestesses. As you pass through the pronaos, your eyes are drawn to the moonlight cascading down from the open ceiling, illuminating an imposing sundial that stands ar the center of the chamber. The moon's rays trace their path across the dial, a silent testament to the passing hours in this eternal sanctuary.

Entering the naos, the very heart of the temple, you find yourself in the presence of the magnificent golden statue of Artemis. Your sister stands tall and proud, her form aglow with a divine radiance that speaks of her unyielding strength and purity. In her left hand, she holds the antlers of a noble deer, symbolizing her dominion over the wild, while her right hand grips her bow, ever ready to protect those who dwell under her watchful eye. A quiver, filled with finely crafted arrows, rests upon her back, the tools of the huntress who lets no prey escape.

At her feet, the altar of Artemis beckons, a place where mortals have laid their offerings, hoping to earn her favor.

>x
What do you want to examine?

>x altar
The altar of Artemis.

>x offering
You can't see any such thing.

>x antlers
You can't see any such thing.

>x bow
Artemis' bow. It is part of Artemis' statue.

At ten past twelve you hear the sound of the moon pocket closing.

I beg your pardon?

>x quiver
Artemis' quiver. It is full of arrows. It is part of Artemis' statue.

>take arrows
That's hardly portable.

>take arrow
You can't see any such thing.

>x back
You can't see any such thing.

>x tools
You can't see any such thing.

>l
Temple of the Aulidean Artemis
 You step into the sacred Temple of Aulidean Artemis, where the scent of incense and ancient prayers is still fresh, despite the absence of the priestesses. As you pass through the pronaos, your eyes are drawn to the moonlight cascading down from the open ceiling, illuminating an imposing sundial that stands ar the center of the chamber. The moon's rays trace their path across the dial, a silent testament to the passing hours in this eternal sanctuary.

Entering the naos, the very heart of the temple, you find yourself in the presence of the magnificent golden statue of Artemis. Your sister stands tall and proud, her form aglow with a divine radiance that speaks of her unyielding strength and purity. In her left hand, she holds the antlers of a noble deer, symbolizing her dominion over the wild, while her right hand grips her bow, ever ready to protect those who dwell under her watchful eye. A quiver, filled with finely crafted arrows, rests upon her back, the tools of the huntress who lets no prey escape.

At her feet, the altar of Artemis beckons, a place where mortals have laid their offerings, hoping to earn her favor.

I beg your pardon?

>x statue
On the base of the statue you can see two locks: one sun-shapped and one moon-shapped.

>put moon shaped key in sun shaped lock
I didn't understand that sentence.

>put moon key in sun lock
You put the moon key in the sun-shapped lock.

You put the moon key into the sun lock.

>put sun key in moon lock
You put the sun key in the moon-shapped lock.

You put the sun key into the moon lock.

>turn moon key
Nothing obvious happens.

>take keys
You can't see any such thing.

>take moon key
You picked up a moon key.

>take sun key
You picked up a sun key.

>put sun key in sun lock
You put the sun key in the sun-shapped lock.

You put the sun key into the sun lock.

>put moon key in moon lock
You put the moon key in the moon-shapped lock.

You put the moon key into the moon lock.

You hear the sound of a locking mechanism unlocking.

>x locking mechanism
You can't see the mechanism, but you can hear it inside the statue.

>x statue
The statue feels wobbly. Maybe you could try pushing it...

>take statue
That's hardly portable.

>eat statue
That's plainly inedible.

>pul statue
That's not a verb I recognise.

>pull statue
It is fixed in place.

>push statue
You push the statue away and you reveal some stairs leading under the temple.

>x stairs
You can't see any such thing.

>take stairs
You can't see any such thing.

>d
Divine Cell of Artemis & Apollo
You can see a Goddess Artemis and a God Apollo here.

>l
Divine Cell of Artemis & Apollo
You can see a Goddess Artemis and a God Apollo here.

>d
You can't go that way.

>d
You can't go that way.

I beg your pardon?

I beg your pardon?

>down
You can't go that way.

>i
You are carrying nothing.

>x
What do you want to examine?

>i
You are carrying nothing.

>l
Divine Cell of Artemis & Apollo
You can see a Goddess Artemis and a God Apollo here.

>take artemis
(the Goddess Artemis)
I don't suppose the Goddess Artemis would care for that.

>kiss artemis
(the Goddess Artemis)
The Goddess Artemis might not like that.

>kiss artemis anyway
You can't see any such thing.

>uffa
That's not a verb I recognise.

>u
Temple of the Aulidean Artemis
 You step into the sacred Temple of Aulidean Artemis, where the scent of incense and ancient prayers is still fresh, despite the absence of the priestesses. As you pass through the pronaos, your eyes are drawn to the moonlight cascading down from the open ceiling, illuminating an imposing sundial that stands ar the center of the chamber. The moon's rays trace their path across the dial, a silent testament to the passing hours in this eternal sanctuary.

Entering the naos, the very heart of the temple, you find yourself in the presence of the magnificent golden statue of Artemis. Your sister stands tall and proud, her form aglow with a divine radiance that speaks of her unyielding strength and purity. In her left hand, she holds the antlers of a noble deer, symbolizing her dominion over the wild, while her right hand grips her bow, ever ready to protect those who dwell under her watchful eye. A quiver, filled with finely crafted arrows, rests upon her back, the tools of the huntress who lets no prey escape.

At her feet, the altar of Artemis beckons, a place where mortals have laid their offerings, hoping to earn her favor.

>u
You can't go that way.

>u
You can't go that way.

* * *

>l
Temple of the Aulidean Artemis
Inside the Temple of the Aulidean Artemis you can see a sundial, the statue of Artemis and her sacrificial altar.

>take flowerbeds
Which do you mean, the red flowerbed, the purple flowerbed, the yellow flowerbed or the white flowerbed?

>take red flowerbed
That's fixed in place.

>take blooms
You can't see any such thing.

>take vines
You can't see any such thing.

>take vine
That's fixed in place.

>eat vine
That's plainly inedible.

>x flowerbed
Which do you mean, the red flowerbed, the purple flowerbed, the yellow flowerbed or the white flowerbed?

>take red flower
You picked up a red flower.

>take purple flower
You picked up a purple flower.

>take white flower
You picked up a white flower.

>take yellow flower
You picked up a yellow flower.

>eat
What do you want to eat?

>i
You are carrying:
  a yellow flower
  a white flower
  a purple flower
  a red flower
  an aria

>eat yellow flower
That's plainly inedible.

>eat aria
That's plainly inedible.

>l
Secret Garden
You find yourself in the Secret Garden, a vibrant haven where nature's palette is on full display. Four flowerbeds burst with color: red, purple, yellow, and white, each a riot of blossoms. To your right, a row of golden amphorae, exuding a sweet, intoxicating perfume, gleams in the sunlight. At the garden's heart stands an enormous willow tree, its ancient trunk hollowed by time, providing a natural cavity within its embrace. Beneath its sprawling branches lies a serene lake, its shore full with delicate sea shells. On the eastern edge of the garden, a heavy gate that seems to lead to the next room, though its form is almost hidden by a tangle of vines and blooms. Nearby, a statue of a strikingly beautiful man stands as if guarding the garden's secrets.

>x sign
The inscription on it reads: For now, the solution is clear: A > red, B > purple, Γ> yellow, Δ>white.

>eat sign
That's plainly inedible.

>x statue
You can see a marble sign on the statue's base. His right hand looks like it could be holding something but there's nothing there.

>eat hand
That's plainly inedible.

>put red flower in hand
You place the red flower in the statue's right hand.

>i
You are carrying:
  a yellow flower
  a white flower
  a purple flower
  an aria

>l
Secret Garden
You find yourself in the Secret Garden, a vibrant haven where nature's palette is on full display. Four flowerbeds burst with color: red, purple, yellow, and white, each a riot of blossoms. To your right, a row of golden amphorae, exuding a sweet, intoxicating perfume, gleams in the sunlight. At the garden's heart stands an enormous willow tree, its ancient trunk hollowed by time, providing a natural cavity within its embrace. Beneath its sprawling branches lies a serene lake, its shore full with delicate sea shells. On the eastern edge of the garden, a heavy gate that seems to lead to the next room, though its form is almost hidden by a tangle of vines and blooms. Nearby, a statue of a strikingly beautiful man stands as if guarding the garden's secrets.

>x amphorae
There are 4 amphorae placed in a line, making inspecting them easier. They are ceramic and on them are depicted scenes painted with thin strokes of golden paint, showcasing excelent craftstmanship. The scenes portray the proccess of perfume making.
 You notice that all of them are a bit dusty, but one - the one on the right.

>tkae amphorae on the right
That's not a verb I recognise.

>take amphora on the right
It's too heavy for you.

>take shiny amphora
It's too heavy for you.

>x shiny amphora
Looking more closely, this amphora depicts a scene of women picking roses. Looking from a bit further, the roses seem to shape a Γ.

>x sign
The inscription on it reads: For now, the solution is clear: A > red, B > purple, Γ> yellow, Δ>white.

>put yellow flower in amphora
You put the yellow flower into the shiny amphora.

>i
You are carrying:
  a white flower
  a purple flower
  an aria

>l
Secret Garden
You find yourself in the Secret Garden, a vibrant haven where nature's palette is on full display. Four flowerbeds burst with color: red, purple, yellow, and white, each a riot of blossoms. To your right, a row of golden amphorae, exuding a sweet, intoxicating perfume, gleams in the sunlight. At the garden's heart stands an enormous willow tree, its ancient trunk hollowed by time, providing a natural cavity within its embrace. Beneath its sprawling branches lies a serene lake, its shore full with delicate sea shells. On the eastern edge of the garden, a heavy gate that seems to lead to the next room, though its form is almost hidden by a tangle of vines and blooms. Nearby, a statue of a strikingly beautiful man stands as if guarding the garden's secrets.

>x lake
It's a beautiful lake full of colourfull water lilies.

>take water lilly
I only understood you as far as wanting to take the water lily.

>take water lily
You picked up a water lily.

>eat water lily
That's plainly inedible.

>i
You are carrying:
  a water lily
  a white flower
  a purple flower
  an aria

>x water lily
It's a cute pink flower.

>take water lily
It would be a shame to remove more of those beautiful flowers. Frogs sleep in them!

>take frog
You can't see any such thing.

>x lake
It's a beautiful lake full of colourfull water lilies.

>go in lake
You can't. All you can see is dirty water.

>d
You can't go down from here.

>swim in lake
That's not a verb I recognise.

>take dirty water
You can't see any such thing.

>l
Secret Garden
You find yourself in the Secret Garden, a vibrant haven where nature's palette is on full display. Four flowerbeds burst with color: red, purple, yellow, and white, each a riot of blossoms. To your right, a row of golden amphorae, exuding a sweet, intoxicating perfume, gleams in the sunlight. At the garden's heart stands an enormous willow tree, its ancient trunk hollowed by time, providing a natural cavity within its embrace. Beneath its sprawling branches lies a serene lake, its shore full with delicate sea shells. On the eastern edge of the garden, a heavy gate that seems to lead to the next room, though its form is almost hidden by a tangle of vines and blooms. Nearby, a statue of a strikingly beautiful man stands as if guarding the garden's secrets.

* * *

>x lake
It's a beautiful lake full of colourfull water lilies.

>x sea shell
You can't see any such thing.

>x sea shells
You notice a big conch shell on top of a pile of random shells.

>take random shell
You can't see any such thing.

>take conch shell
It's stuck in place. It looks like it's here for a reason.

>x conch shell
You examine the conch shell. The poor creature that used to inhabit it must be long gone, surely after having made it to old age. In the iridescent insides you can faintly see a carving: Β.

>x sign
The inscription on it reads: For now, the solution is clear: A > red, B > purple, Γ> yellow, Δ>white.

>put purple flower in conch shell
You put the purple flower into the conch shell.

>x
What do you want to examine?

>l
Secret Garden
You find yourself in the Secret Garden, a vibrant haven where nature's palette is on full display. Four flowerbeds burst with color: red, purple, yellow, and white, each a riot of blossoms. To your right, a row of golden amphorae, exuding a sweet, intoxicating perfume, gleams in the sunlight. At the garden's heart stands an enormous willow tree, its ancient trunk hollowed by time, providing a natural cavity within its embrace. Beneath its sprawling branches lies a serene lake, its shore full with delicate sea shells. On the eastern edge of the garden, a heavy gate that seems to lead to the next room, though its form is almost hidden by a tangle of vines and blooms. Nearby, a statue of a strikingly beautiful man stands as if guarding the garden's secrets.

>x trunk
You can't see any such thing.

>x tree
(the weeping willow)
It is an old, a majestic weeping willow tree. The visible part of the roots is thick and healthy, they probably run through the entire garden. You can easily see a cavity in the middle.

>take root
You can't see any such thing.

>x cavity
The cavity itself is shaped like a Δ.

>put red flower in cavity
(first taking the red flower)
You picked up a red flower.

You put the red flower into the tree cavity.

>l
Secret Garden
You find yourself in the Secret Garden, a vibrant haven where nature's palette is on full display. Four flowerbeds burst with color: red, purple, yellow, and white, each a riot of blossoms. To your right, a row of golden amphorae, exuding a sweet, intoxicating perfume, gleams in the sunlight. At the garden's heart stands an enormous willow tree, its ancient trunk hollowed by time, providing a natural cavity within its embrace. Beneath its sprawling branches lies a serene lake, its shore full with delicate sea shells. On the eastern edge of the garden, a heavy gate that seems to lead to the next room, though its form is almost hidden by a tangle of vines and blooms. Nearby, a statue of a strikingly beautiful man stands as if guarding the garden's secrets.

>i
You are carrying:
  a water lily
  a white flower
  an aria

>x gate
The puzzle gate is tightly closed.

>x golden anphora
I only understood you as far as wanting to examine the golden amphorae.

>x golden amphora
Looking more closely, this amphora depicts a scene of women picking roses. Looking from a bit further, the roses seem to shape a Γ.

>i
You are carrying:
  a water lily
  a white flower
  an aria

>x sign
The inscription on it reads: For now, the solution is clear: A > red, B > purple, Γ> yellow, Δ>white.

>take red flower from trunk
You can't see any such thing.

>take red flower from cavity
You picked up a red flower.

>x cavity
The cavity itself is shaped like a Δ.

>put white flower in cavity
You put the white flower into the tree cavity.

You hear the sound of the gate opening

>l
Secret Garden
You find yourself in the Secret Garden, a vibrant haven where nature's palette is on full display. Four flowerbeds burst with color: red, purple, yellow, and white, each a riot of blossoms. To your right, a row of golden amphorae, exuding a sweet, intoxicating perfume, gleams in the sunlight. At the garden's heart stands an enormous willow tree, its ancient trunk hollowed by time, providing a natural cavity within its embrace. Beneath its sprawling branches lies a serene lake, its shore full with delicate sea shells. On the eastern edge of the garden, a heavy gate that seems to lead to the next room, though its form is almost hidden by a tangle of vines and blooms. Nearby, a statue of a strikingly beautiful man stands as if guarding the garden's secrets.

>x hands
You notice the number Α carved on its index finger.
It's holding a red flower.

>e
Divine Cell 4
devine cell 4 description TODO

You can see Aphrodite and Hephaestus here.

>eat Aphrodite
She's plainly inedible.

>eat Hephaestus
He's plainly inedible.

>w
Secret Garden
You find yourself in the Secret Garden, a vibrant haven where nature's palette is on full display. Four flowerbeds burst with color: red, purple, yellow, and white, each a riot of blossoms. To your right, a row of golden amphorae, exuding a sweet, intoxicating perfume, gleams in the sunlight. At the garden's heart stands an enormous willow tree, its ancient trunk hollowed by time, providing a natural cavity within its embrace. Beneath its sprawling branches lies a serene lake, its shore full with delicate sea shells. On the eastern edge of the garden, a heavy gate that seems to lead to the next room, though its form is almost hidden by a tangle of vines and blooms. Nearby, a statue of a strikingly beautiful man stands as if guarding the garden's secrets.

>u
Throne Room
Home to the King of Paphos, Cinyras.

You can see Cinyras here.

>i
You are carrying:
  a red flower
  a water lily
  an aria

>take everything
There are none at all available!

>take all
There are none at all available!

>take @a
You can't see any such thing.

>take [object Object]
You can't see any such thing.

>eat flower
Yuck. Why would you make me eat that Ema?

>eat white flower
You can't see any such thing.

>take white flower
You can't see any such thing.

>l
Throne Room
Home to the King of Paphos, Cinyras.

You can see Cinyras here.

>w
You can't go that way.

>d
Secret Garden
You find yourself in the Secret Garden, a vibrant haven where nature's palette is on full display. Four flowerbeds burst with color: red, purple, yellow, and white, each a riot of blossoms. To your right, a row of golden amphorae, exuding a sweet, intoxicating perfume, gleams in the sunlight. At the garden's heart stands an enormous willow tree, its ancient trunk hollowed by time, providing a natural cavity within its embrace. Beneath its sprawling branches lies a serene lake, its shore full with delicate sea shells. On the eastern edge of the garden, a heavy gate that seems to lead to the next room, though its form is almost hidden by a tangle of vines and blooms. Nearby, a statue of a strikingly beautiful man stands as if guarding the garden's secrets.

I beg your pardon?

>;
That's not a verb I recognise.

>l
Secret Garden
You find yourself in the Secret Garden, a vibrant haven where nature's palette is on full display. Four flowerbeds burst with color: red, purple, yellow, and white, each a riot of blossoms. To your right, a row of golden amphorae, exuding a sweet, intoxicating perfume, gleams in the sunlight. At the garden's heart stands an enormous willow tree, its ancient trunk hollowed by time, providing a natural cavity within its embrace. Beneath its sprawling branches lies a serene lake, its shore full with delicate sea shells. On the eastern edge of the garden, a heavy gate that seems to lead to the next room, though its form is almost hidden by a tangle of vines and blooms. Nearby, a statue of a strikingly beautiful man stands as if guarding the garden's secrets.

>take white flower
You picked up a white flower.

>eat white flower
That's plainly inedible.

>eat flower
Which do you mean, a white flower, a red flower, a purple flower or a yellow flower?

>i
You are carrying:
  a white flower
  a red flower
  a water lily
  an aria

>eat red flower
Yuck. Why would you make me eat that Ema?

>eat red flower
Yuck. Why would you make me eat that Ema?

>EAT THE RED FLOWER
Yuck. Why would you make me eat that Ema?

>UFFI
That's not a verb I recognise.

>I WANNA EAT THE RED FLOWER
I only understood you as far as wanting to take inventory.

>I WANT TO EAT THE RED FLOWER
I only understood you as far as wanting to take inventory.

>i
You are carrying:
  a white flower
  a red flower
  a water lily
  an aria

>x aria
You see nothing special about the aria.

>go in lake
You swim through the waters.

Divine Cell 4
devine cell 4 description TODO

You can see Aphrodite and Hephaestus here.

>smell red flower
It smells good.

>smell white flower
It smells amazing.

>smell white flower
It smells amazing.

>fdsajklhdsafhkjlfdasjfhdjasadfjhkasdhjjasdfsfhjkadfdhjkasjfhksdfasjkhdhkfjadfhjkahjkasdfashdjfkshadfjklashfdjklahsdfjlkhasdfjkllfjkdashahdjfklfkjdhllasahdfj
That's not a verb I recognise.

>l
Divine Cell 4
devine cell 4 description TODO

You can see Aphrodite and Hephaestus here.

>x
What do you want to examine?

>u
You see nothing unexpected in that direction.

>l
Divine Cell 4
devine cell 4 description TODO

You can see Aphrodite and Hephaestus here.

>w
Secret Garden
You find yourself in the Secret Garden, a vibrant haven where nature's palette is on full display. Four flowerbeds burst with color: red, purple, yellow, and white, each a riot of blossoms. To your right, a row of golden amphorae, exuding a sweet, intoxicating perfume, gleams in the sunlight. At the garden's heart stands an enormous willow tree, its ancient trunk hollowed by time, providing a natural cavity within its embrace. Beneath its sprawling branches lies a serene lake, its shore full with delicate sea shells. On the eastern edge of the garden, a heavy gate that seems to lead to the next room, though its form is almost hidden by a tangle of vines and blooms. Nearby, a statue of a strikingly beautiful man stands as if guarding the garden's secrets.

>l
Secret Garden
You find yourself in the Secret Garden, a vibrant haven where nature's palette is on full display. Four flowerbeds burst with color: red, purple, yellow, and white, each a riot of blossoms. To your right, a row of golden amphorae, exuding a sweet, intoxicating perfume, gleams in the sunlight. At the garden's heart stands an enormous willow tree, its ancient trunk hollowed by time, providing a natural cavity within its embrace. Beneath its sprawling branches lies a serene lake, its shore full with delicate sea shells. On the eastern edge of the garden, a heavy gate that seems to lead to the next room, though its form is almost hidden by a tangle of vines and blooms. Nearby, a statue of a strikingly beautiful man stands as if guarding the garden's secrets.

>go in lake
You swim through the waters.

Divine Cell 4
devine cell 4 description TODO

You can see Aphrodite and Hephaestus here.

>drop red flower
Dropped.

>go out of lake
I only understood you as far as wanting to go outside.

>go e
You can't go that way.

>l
Divine Cell 4
devine cell 4 description TODO

You can see a red flower, Aphrodite and Hephaestus here.

>w
Secret Garden
You find yourself in the Secret Garden, a vibrant haven where nature's palette is on full display. Four flowerbeds burst with color: red, purple, yellow, and white, each a riot of blossoms. To your right, a row of golden amphorae, exuding a sweet, intoxicating perfume, gleams in the sunlight. At the garden's heart stands an enormous willow tree, its ancient trunk hollowed by time, providing a natural cavity within its embrace. Beneath its sprawling branches lies a serene lake, its shore full with delicate sea shells. On the eastern edge of the garden, a heavy gate that seems to lead to the next room, though its form is almost hidden by a tangle of vines and blooms. Nearby, a statue of a strikingly beautiful man stands as if guarding the garden's secrets.

* * *

>l
Temple of the Aulidean Artemis
Inside the Temple of the Aulidean Artemis you can see a sundial, the statue of Artemis and her sacrificial altar.

>x puzzle gate
The puzzle gate is tightly closed.

>look puzzle gate
The puzzle gate is tightly closed.

>x statue
The statue depicts a beautiful man. There is a sign on the statue's base. His hands look like they're holding something but there's nothing there. You notice the Greek number A on the statue.

>take beautiful man
You can't see any such thing.

>read sign
The sign is made of marble. The inscription on it reads: Painful memories of our love surround this place. (A > red, B > purple, C> yellow, D>white)

>open puzzle gaet
I only understood you as far as wanting to open the puzzle gate.

>open puzzle gate
It isn't something you can open.

>x statue
The statue depicts a beautiful man. There is a sign on the statue's base. His hands look like they're holding something but there's nothing there. You notice the Greek number A on the statue.

>x hands
The hands is empty.

>take The hands
That seems to be a part of the statue.

>take statue
That's fixed in place.

>k
That's not a verb I recognise.

>l
Secret Garden
You are in the Secret Garden

You find yourself before a beautiful flowerbed with vibrant red flowers.

You find yourself before a beautiful flowerbed with vibrant purple flowers.

You find yourself before a beautiful flowerbed with vibrant yellow flowers.

You find yourself before a beautiful flowerbed with vibrant white flowers.

You can also see a puzzle gate, a statue, a container B (empty), a container C (empty) and a container D (empty) here.

>take flowers
red flower: You picked up a red flower.
red flower: You picked up a red flower.
red flower: You picked up a red flower.
red flower: You picked up a red flower.
red flower: You picked up a red flower.
red flower: You picked up a red flower.
red flower: You picked up a red flower.
red flower: You picked up a red flower.
red flower: You picked up a red flower.
red flower: That was the last red flower. There are no more in this garden.
purple flower: You picked up a purple flower.
purple flower: You picked up a purple flower.
purple flower: You picked up a purple flower.
purple flower: You picked up a purple flower.
purple flower: You picked up a purple flower.
purple flower: You picked up a purple flower.
purple flower: You picked up a purple flower.
purple flower: You picked up a purple flower.
purple flower: You picked up a purple flower.
purple flower: That was the last purple flower. There are no more in this garden.
yellow flower: You picked up a yellow flower.
yellow flower: You picked up a yellow flower.
yellow flower: You picked up a yellow flower.
yellow flower: You picked up a yellow flower.
yellow flower: You picked up a yellow flower.
yellow flower: You picked up a yellow flower.
yellow flower: You picked up a yellow flower.
yellow flower: You picked up a yellow flower.
yellow flower: You picked up a yellow flower.
yellow flower: That was the last yellow flower. There are no more in this garden.
white flower: You picked up a white flower.
white flower: You picked up a white flower.
white flower: You picked up a white flower.
white flower: You picked up a white flower.
white flower: You picked up a white flower.
white flower: You picked up a white flower.
white flower: You picked up a white flower.
white flower: You picked up a white flower.
white flower: You picked up a white flower.
white flower: That was the last white flower. There are no more in this garden.

>x red flowers flowerbed
You can't use multiple objects with that verb.

>x flowerbed
Which do you mean, the red flowerbed, the purple flowerbed, the yellow flowerbed or the white flowerbed?

>x red flowerbed
You can see some red flowers in this flowerbed

>x purple flowerbed
You can see some purple flowers in this flowerbed

>x yellow flowerbed
You can see some yellow flowers in this flowerbed

>take flowers from red flowerbed
You can't see any such thing.

>x sign
The sign is made of marble. The inscription on it reads: Painful memories of our love surround this place. (A > red, B > purple, C> yellow, D>white)

>put red flowers in hands
red flower: Done.
red flower: There is no more room in the hands.
red flower: There is no more room in the hands.
red flower: There is no more room in the hands.
red flower: There is no more room in the hands.
red flower: There is no more room in the hands.
red flower: There is no more room in the hands.
red flower: There is no more room in the hands.
red flower: There is no more room in the hands.
red flower: There is no more room in the hands.

>put purple flowers in container b
purple flower: Done.
purple flower: There is no more room in the container B.
purple flower: There is no more room in the container B.
purple flower: There is no more room in the container B.
purple flower: There is no more room in the container B.
purple flower: There is no more room in the container B.
purple flower: There is no more room in the container B.
purple flower: There is no more room in the container B.
purple flower: There is no more room in the container B.
purple flower: There is no more room in the container B.

>x containers
Which do you mean, the red flowerbed, the purple flowerbed, the yellow flowerbed, the white flowerbed, the hands, the container B, the container C or the container D?

>x container b
In the container B is a purple flower.

>put yellow flowers in container c
yellow flower: Done.
yellow flower: There is no more room in the container C.
yellow flower: There is no more room in the container C.
yellow flower: There is no more room in the container C.
yellow flower: There is no more room in the container C.
yellow flower: There is no more room in the container C.
yellow flower: There is no more room in the container C.
yellow flower: There is no more room in the container C.
yellow flower: There is no more room in the container C.
yellow flower: There is no more room in the container C.

>put white flowers in container d
white flower: Done.
white flower: There is no more room in the container D.
white flower: There is no more room in the container D.
white flower: There is no more room in the container D.
white flower: There is no more room in the container D.
white flower: There is no more room in the container D.
white flower: There is no more room in the container D.
white flower: There is no more room in the container D.
white flower: There is no more room in the container D.
white flower: There is no more room in the container D.

You hear the sound of the gate opening

>close gate
It isn't something you can close.

>take flowers
red flower: That was the last red flower. There are no more in this garden.
purple flower: That was the last purple flower. There are no more in this garden.
yellow flower: That was the last yellow flower. There are no more in this garden.
white flower: That was the last white flower. There are no more in this garden.

You hear the sound of the gate closing.

>go in gate
(first opening the puzzle gate)
It isn't something you can open.

>enter gate
(first opening the puzzle gate)
It isn't something you can open.

>put back the flowers
You can't see any such thing.

>put red flower in hands
You put the red flower into the hands.

>put purple flower in container b
You put the purple flower into the container B.

>put yellow flower in container c
You put the yellow flower into the container C.

>put white flower in container d
You put the white flower into the container D.

You hear the sound of the gate opening

>go in gate
(first opening the puzzle gate)
It isn't something you can open.

* * *

>enter gate
(first opening the puzzle gate)
It isn't something you can open.

>e
Divine Cell 4
You see the gods sleeping

You can see a puzzle gate, Aphrodite and Hephaestus here.

>w
Secret Garden
You are in the Secret Garden

You find yourself before a beautiful flowerbed with vibrant red flowers.

You find yourself before a beautiful flowerbed with vibrant purple flowers.

You find yourself before a beautiful flowerbed with vibrant yellow flowers.

You find yourself before a beautiful flowerbed with vibrant white flowers.

You can also see a puzzle gate, a statue, a container B (in which is a purple flower), a container C (in which is a yellow flower) and a container D (in which is a white flower) here.

>w
(first opening the puzzle gate)
It isn't something you can open.

* * *

>l
Temple of the Aulidean Artemis
Inside the Temple of the Aulidean Artemis you can see a sundial, the statue of Artemis and her sacrificial altar.

>x sundial
The dial is designed with two separate rings encircling its plate, one with sun and one with lunar markings, allowing you to read the time day and night. You also see on the gnomon an inscription engraved and gilded in gold that says: At midday, let Apollo's light cast a shadow, and at midnight, let Artemis' glow guide the way. Only then shall the twins unveil the hidden path.

Judging by the gnomon's shadow and the sun markings, the time is nine o'clock.

>x sundial
The inscription engraved on the gnomon read: At midday, let Apollo's light cast no shadow, and at midnight, let Artemis' glow guide the way. Only then shall the twins unveil the hidden path.

Judging by the gnomon's shadow and the sun markings, the time is nine o'clock.

>wait until midday
It is twelve o'clock now.

At twelve o'clock  you hear the click of a latch releasing and a sun hatch opening coming from the dial.

>wait until midnight
At ten past twelve you hear the sound of the sun hatch closing and the click of a latch locking coming from the dial.

It is twelve o'clock now.

The day passes.

At twelve o'clock you hear the click of a latch releasing and a moon hatch opening coming from the dial.

>scenes
Scene 'Entire Game' playing (for -539 mins now)
(Scene monitoring now switched on. Type "scenes off" to switch it off again.)

* * *

I beg your pardon?

>take ambrosia
You picked up a Ambrosia.

>give ambrosia to heracles
Hercules says "I am grateful my dearest, but I think you might need this more than I.

>give ambrosia to zeus
God Zeus doesn't look like he needs more ambrosia right now.

>give ambrosia to Hera
Goddess Hera doesn't look like she needs more ambrosia right now.

>give club to heracles
(first taking the Heracles' Club)
You picked up a Heracles' Club.

He smiles to you. "Thank you my dearest."

You give the Heracles' Club to the God Heracles.

* * *

>[enter]
Garden of Hesperides

From here you can sail to: 
→ Piraeus
→ Sounio
→ Aulis
→ Paphos

You can see Aigle, Arethousa, Erytheia and Hesperie here.

>i
You are carrying:
  a Heracles' Club
  Ambrosia

>sail to aulis
You sail to the Port of Aulis.

Port of Aulis
From here you can sail to: 
→ Sounio
→ Garden of Hesperides

>e
You can't go that way.

>w
Agora of Aulis

* * *

>n
Agora of Thebes

>go to kadmea
You can't see any such thing.

>enter kadmea
You went into the kadmea
Kadmea
on the walls you can see the story of Kadmos, who slayed the Dragon of Ismenus and burried his teeth for the Spartoi to sprink from the ground. In front of you is a stone dragon statue, and a big chess board with some chess pieces already on top. You can see a sacrificial plate on top of the altar. The dvgate has a sign on it.

You can see a dvgate, a rock, a walls, dragon statue, a Kadmea altar (on which is a sacrificial plate (empty)), a pan1, a pan2, a pan3, a pan4, a pan5, a pan6 and a scale here.

>test cad
(Testing.)

>[1] x dragon statue
The statue's mouth is closed.

>[2] put rock on dragon head
(first taking the rock)
You picked up a rock.

You put the rock on the dragon head.

The statue's mouth opened.

>[3] x dragon statue
 You see 6 tooth inside the statue's mouth.

>[4] take 6 dragon teeth
dragon tooth: You picked up a dragon tooth.
dragon tooth: You picked up a dragon tooth.
dragon tooth: You picked up a dragon tooth.
dragon tooth: You picked up a dragon tooth.
dragon tooth: You picked up a dragon tooth.
dragon tooth: You picked up a dragon tooth.

>[5] put 6 dragon teeth in the plate
dragon tooth: Done.
dragon tooth: Done.
dragon tooth: Done.
dragon tooth: Done.
dragon tooth: Done.
dragon tooth: Done.

The dragon teeth are syphoned into the altar and a compartment door opens, exposing 6 weights.

>test dvdoor
>--> The following tests are available:
'test cad'
'test gate'
'test pos'
'test art'
'test fire'

>test gate
(Testing.)

>[1] take weights
weight1: You picked up a weight1.
weight2: You picked up a weight2.
weight3: You picked up a weight3.
weight4: You picked up a weight4.
weight5: You picked up a weight5.
weight6: You picked up a weight6.

>[2] put weight1 on pan1
You put the weight1 on the pan1.

>[3] put weight2 on pan2
You put the weight2 on the pan2.

>[4] put weight3 on pan3
You put the weight3 on the pan3.

>[5] put weight4 on pan4
You put the weight4 on the pan4.

>[6] put weight5 on pan5
You put the weight5 on the pan5.

>[7] put weight6 on pan6
You put the weight6 on the pan6.

You hear the sound of the gate mechanism unlocking

>go in gate
(first opening the dvgate)

Divine Cell 1
You can see a dvgate here.

>l
Divine Cell 1
You can see a dvgate here.

>showme
Divine Cell 1 - room
    dvgate - open door
        dvsign (part of dvgate)
    yourself - woman
        Heracles' Club
        Ambrosia
    Goddess Athena - woman
    God Ares - man

>give ambrosia to athena
You gave ambrosia to Goddess Athena.

>showme athena
Goddess Athena - woman
location: in Divine Cell 1
unlit, inedible, portable; transparent, female, immortal, awake; singular-named, improper-named
description: none
initial appearance: none
smell: neutral
carrying capacity: 100
name: none
printed name: "Goddess Athena"
printed plural name: "women"
indefinite article: none
list grouping key: none

>go out
You can't go that way.

>enter gate
You can't see any such thing.

* * *

I beg your pardon?

>take obol and take ambrosia
You can't see any such thing.

>take obol
You picked up a obol.

>take ambrosia
You picked up a Ambrosia.

>give club to heracles
(first taking the Heracles' Club)
You picked up a Heracles' Club.

He smiles to you. "Thank you my dearest."

You give the Heracles' Club to the God Heracles.

* * *

>[enter]
Garden of Hesperides

From here you can sail to: 
→ Piraeus
→ Sounio
→ Aulis
→ Paphos

You can see Aigle, Arethousa, Erytheia and Hesperie here.

>sail to aulis
You sail to the Port of Aulis.

Port of Aulis
From here you can sail to: 
→ Sounio
→ Garden of Hesperides

* * *

>e
East of Ephyra
You can see a Charon's boat and Charon here.

>give obol to charon
You give obol to Charon.

The ferryman accepts the token and signals you to jump into the boat. With slow and certain movements, he leads the boat down the dangerous stream, into the opening of a natural cave. You arrive at the Underworld.

>[enter]
Elysian Fields
You can see a Charon's boat here.

>d
Asphodel Meadows
You can see a broken bridge and a plaque here.

>showme
Asphodel Meadows - room
    yourself - woman
        Heracles' Club
        Ambrosia
    God Heracles - man
    broken bridge - closed door
    plaque

>give ambrosia to heracles
You gave ambrosia to God Heracles.

>showme heracles
God Heracles - man
location: in the Asphodel Meadows
unlit, inedible, portable; transparent, male, immortal, awake; singular-named, improper-named
description: none
initial appearance: none
smell: neutral
carrying capacity: 100
name: none
printed name: "God Heracles"
printed plural name: "men"
indefinite article: none
list grouping key: none

>i
You are carrying:
  a Heracles' Club
  Ambrosia

>u
Elysian Fields
You can see Charon and a Charon's boat here.

* * *

I beg your pardon?

>test
>--> The following tests are available:
'test me'

>test me
(Testing.)

>[1] look
Secret Garden
You are in the Secret Garden

You find yourself before a beautiful flowerbed with vibrant red flowers.

You find yourself before a beautiful flowerbed with vibrant purple flowers.

You find yourself before a beautiful flowerbed with vibrant yellow flowers.

You find yourself before a beautiful flowerbed with vibrant white flowers.

You can also see a puzzle gate, a statue, a container B (empty), a container C (empty) and a container D (empty) here.

>[2] put red flower in hands
(first taking the red flower)
You picked up a red flower.

You put the red flower into the hands.

>[3] put purple flower in b
(first taking the purple flower)
You picked up a purple flower.

You put the purple flower into the container B.

>[4] put yellow flower in c
(first taking the yellow flower)
You picked up a yellow flower.

You put the yellow flower into the container C.

>[5] put white flower in d
(the container D)
(first taking the white flower)
You picked up a white flower.

You put the white flower into the container D.

>[6] look
Secret Garden
You are in the Secret Garden

You find yourself before a beautiful flowerbed with vibrant red flowers.

You find yourself before a beautiful flowerbed with vibrant purple flowers.

You find yourself before a beautiful flowerbed with vibrant yellow flowers.

You find yourself before a beautiful flowerbed with vibrant white flowers.

You can also see a puzzle gate, a statue, a container B (in which is a purple flower), a container C (in which is a yellow flower) and a container D (in which is a white flower) here.

>[7] east

Divine Cell 4
You see the gods sleeping

You can see a puzzle gate, Aphrodite and Hephaestus here.

* * *

I beg your pardon?

>λ
That's not a verb I recognise.

>l
Mount Olympus Hall
You can see Heracles, Zeus, Hera, Demeter, Hestia, Poseidon, Aphrodite, Apollo, Artemis, Athena, Ares, Dionysus, Hephaestus and Hermes. Ganymedes is running around, serving nectar on request.

>take artemis
I don't suppose the Goddess Artemis would care for that.

>take nectar
You can't see any such thing.

>>;(
That's not a verb I recognise.

>x heracles
Heracles, strong in a lion-skin cloak over a short tunic with a garland of olive leaves, feels deep gratitude and pride, his heart swelling as he is celebrated among the gods.

>speak with heracles
Whom do you want to speak that to?

>talk to heracles
You can't see any such thing.

>speak to heracles
I didn't understand that sentence.

>x heracles
Heracles, strong in a lion-skin cloak over a short tunic with a garland of olive leaves, feels deep gratitude and pride, his heart swelling as he is celebrated among the gods.

>talk to heracles
That's not a verb I recognise.

>smell heracles
It smells neutral.

>ask heracless about his cloack
You can't see any such thing.

>ask heracless about his cloak
You can't see any such thing.

>l
Mount Olympus Hall
You can see Heracles, Zeus, Hera, Demeter, Hestia, Poseidon, Aphrodite, Apollo, Artemis, Athena, Ares, Dionysus, Hephaestus and Hermes. Ganymedes is running around, serving nectar on request.

>talk to heracles about his celebration
That's not a verb I recognise.

>tell to heracles about his celebration
You can't see any such thing.

>ask to heracles about his celebration
You can't see any such thing.

>tell heracles about his celebration
Yes i like it!

>tell heracles about his celebration
huh its nice

>x heracles
Heracles, strong in a lion-skin cloak over a short tunic with a garland of olive leaves, feels deep gratitude and pride, his heart swelling as he is celebrated among the gods.

* * *

>smell heracles
It smells neutral.

>smell heracles
It smells neutral.

>tell heracles about his celebration
oof.

>tell heracles about his celebration
Yes i like it!

* * *

>tell heracles about his celebration
huh its nice

>tell heracles about his celebration
oof.

* * *

>tell heracles about his celebration
Yes i like it!

I beg your pardon?

>l
Mount Olympus Hall
You can see Heracles, Zeus, Hera, Demeter, Hestia, Poseidon, Aphrodite, Apollo, Artemis, Athena, Ares, Dionysus, Hephaestus and Hermes. Ganymedes is running around, serving nectar on request.

>x zeus
Zeus, with his majestic white hair and beard, wears a gold-trimmed white toga and a laurel crown. He feels immense pride in Heracles, his eyes bright with pride.

>smell zeus
It smells neutral.

* * *

>x apollo
Apollo, radiant in a gold-trimmed white tunic with a laurel wreath in his golden hair, feels joy and admiration, his spirit lifted as he observes the celebration of his half-brother.

* * *

>request nectar
That's not a verb I recognise.

>x room
You can't see any such thing.

>l
Mount Olympus Hall
You can see Heracles, Zeus, Hera, Demeter, Hestia, Poseidon, Aphrodite, Apollo, Artemis, Athena, Ares, Dionysus, Hephaestus and Hermes. Ganymedes is running around, serving nectar on request.

>x club
You see nothing special about the Heracles' Club.

>take club
You picked up a Heracles' Club.

>i
You are carrying:
  a Heracles' Club

>smell club
It smells neutral.

>give club to zeus
You give the Heracles' Club to the God Zeus.

>take club
That seems to belong to the God Zeus.

* * *

>X DEER
A deer, one of Artemis' symbols. It is part of Artemis' statue.

>x arrow
You can't see any such thing.

>x arrows
Artemis' arrows. It is part of Artemis' statue.

>x quiver
Artemis' quiver. It is full of arrows. It is part of Artemis' statue.

>x altar
You can't see any such thing.

* * *

>X WAX TABLET
_  _ _ _ _  _ _ _ _ _ _  _ _ _ _  _ _ _ _ _  _ _.  _ _ _ _ _  _ _  _ _ _ _ _  _ _  _ _ _  _ _ _ _  _ _ _  _ _ _ _  _ _. 

S QWJC WOEBQCD BCTB  PONCD UC. FDSOA  UC GZEIC BE BQC  VSDC WON  DCWN SB.

>bring wax tablet close to fire
The warmth of the hearth made the wax melt. It revealed some engraved writing under it.

>x wax tablet
The writing reads: Light the tenth, eleventh and thirtheenth torches.

* * *

>actions
Actions listing on.

>give club to heracle
You can't see any such thing.

>give club to heracles
[giving the Heracles' Club to the God Heracles]
(first taking the Heracles' Club)
[(1) taking the Heracles' Club - silently]
You picked up a Heracles' Club.

[(1) taking the Heracles' Club - silently - succeeded]

He smiles to you. "Thank you my dearest."

[giving the Heracles' Club to the God Heracles - succeeded]

>[enter]
Suddenly, an eerie silence fell over the festive night. The singing and dancing ceased, as if an unseen hand had stilled them. For a brief moment, you felt the coldness of the mountain air, a stark contrast to the pleasant breeze that had enveloped you moments before. A sense of foreboding fills you as you become aware that all eyes are turned behind you. You lock eyes with Heracles, both of you sharing a look of worry. With a growing sense of dread, you turned to see what had drawn everyone's attention.

"Oh dear, please, do not let my presence taint your insignificant gathering. Carry on as you were."

The voice was unmistakable, deep and resonant, carrying an ancient power that sent shivers down your spine. It was Kronos. So much time has passed since our triumph in the War of Titans- the Titanomachy. How did he manage to escape Tartarus?

The sight of the Titan, towering and menacing, shrouded in shadows, struck fear into the hearts of all present. You start to feel the ichor in your divine veins turn cold, as if time itself had frozen. The gods, normally so mighty and formidable, stand paralyzed in shock. Nothing moves. In a heartbeat, you break free from the daze and come to your senses. Your next actions have never been more certain. It's now or never.

You grab Heracle's club out of his hands and leap towards Kronos. Then you feel yourself slipping into unconciousness.

>[enter]
[looking]
Garden of Hesperides

From here you can sail to: 
→ Piraeus
→ Sounio
→ Aulis
→ Paphos

You can see Eternal Chalice of Nectar, Aigle, Arethousa, Erytheia and Hesperie here.

[looking - succeeded]

>sail to aulis
[sailing Port of Aulis]
You sail to the Port of Aulis.

[(1) looking]
Port of Aulis
From here you can sail to: 
→ Sounio
→ Garden of Hesperides

[(1) looking - succeeded]

[sailing Port of Aulis - succeeded]

>w
[going west]

Agora of Aulis
[going west - succeeded]

>s
[going south]

Gates of Aulis
From here you can travel to: 
→ Thebes
→ Athens
→  Delphi
→ Ephyra
→ Mount Olympus

[going south - succeeded]

>travel to ephyra
[traveling Gates of Ephyra]
You travel to the Gates of Ephyra.

[(1) looking]
Gates of Ephyra
From here you can travel to: 
→ Mount Olympus 
→ Athens
→ Thebes
→ Aulis
→ Delphi

[(1) looking - succeeded]

[traveling Gates of Ephyra - succeeded]

>e
[going east]

East of Ephyra
You can see a Charon's boat and Charon here.

[going east - succeeded]

>w
[going west]

Gates of Ephyra
From here you can travel to: 
→ Mount Olympus 
→ Athens
→ Thebes
→ Aulis
→ Delphi

[going west - succeeded]

>n
[going north]

North of Ephyra
[going north - succeeded]

>enter necromanteion
[entering the necromanteion]
You went into the necromanteion
[(1) looking]
Necromanteion
You can see a necromanteion altar and a flower here.

[(1) looking - succeeded]

[entering the necromanteion - succeeded]

>sacrifice flower
[sacrificing the flower]
(first taking the flower)
[(1) taking the flower - silently]
You picked up a flower.

[(1) taking the flower - silently - succeeded]

You put the flower on the altar and, with the help of the Priestess, you light it on fire. Nyx acknowledges you.

You gained an obol from the sacrifice.
[sacrificing the flower - succeeded]

>o
Sorry, that can't be corrected.

>out
[exiting]
[(1) going outside]

North of Ephyra
[(1) going outside - succeeded]

[exiting - succeeded]

>w
[going west]
You can't go that way.
[going west - failed the can't go that way rule]

>s
[going south]

Gates of Ephyra
From here you can travel to: 
→ Mount Olympus 
→ Athens
→ Thebes
→ Aulis
→ Delphi

[going south - succeeded]

>e
[going east]

East of Ephyra
You can see a Charon's boat and Charon here.

[going east - succeeded]

>give 1 obol to charon
[giving an obol to Charon]
You give 1 obol to Charon.
[giving 0 obol to Charon - succeeded]

The ferryman accepts the token and signals you to jump into the boat. With slow and certain movements, he leads the boat down the dangerous stream, into the opening of a natural cave. You arrive at the Underworld.

* * *

>actions
Actions listing on.

>show actions
You can't see any such thing.

>pick up red flower
[taking the red flower]
You picked up a red flower.
[taking the red flower - succeeded]

* * *

>ask heracles about his club]
There is no reply.

>ask heracles about his club
Ah its over there

>tell heracles about his club
Ah its over there

* * *

>ask hercules about his celebration
You can't see any such thing.

>ask heracles about his celebration
Yes i like it!

>ask heracles about his celebration
huh its nice

>ask heracles about his celebration
oof.

>ask heracles about his celebration
Yes i like it!

* * *

>check torches
You can't use multiple objects with that verb.

>x chair
You see nothing special about the chair.

>s
You can't go that way.

>save
Ok.

>load
That's not a verb I recognise.

>open
What do you want to open?

* * *

>complete the game
That's not a verb I recognise.

>i
You are carrying nothing.

>i take nothing
I only understood you as far as wanting to take inventory.

>read sign
The sign is made of marble. The inscription on it reads: Painful memories of our love surround this place.

>take sign
Taken.

>see statue
That's not a verb I recognise.

>look at statue
The statue depicts a beautiful man. He's holding a basket.  It is empty.

>take statue
Taken.

>i
You are carrying:
  a statue
  a sign

>examine statue in inventory
I only understood you as far as wanting to examine the statue.

>examine statue
The statue depicts a beautiful man. He's holding a basket.  It is empty.

>look
Secret Garden
You are in the Secret Garden

You find yourself before a beautiful flowerbed with vibrant red flowers.

>examine flowerbed
You can see some red flowers in this flowerbed

In the flowerbed are ten red flowers.

>take flowerbed
Taken.

>look
Secret Garden
You are in the Secret Garden

>take secret garden
You can't see any such thing.

>i
You are carrying:
  a flowerbed
    ten red flowers
  a statue
  a sign

>take red flowers
What do you want to take those things from?

>from flowerbed
You can't see any such thing.

>put down flowerbed
Dropped.

>take flowers from flowerbed
red flower: You picked up a red flower.
red flower: You picked up a red flower.
red flower: You picked up a red flower.
red flower: You picked up a red flower.
red flower: You picked up a red flower.
red flower: You picked up a red flower.
red flower: You picked up a red flower.
red flower: You picked up a red flower.
red flower: You picked up a red flower.
red flower: That was the last red flower. There are no more in this garden.

>take flowerbed
Taken.

>i
You are carrying:
  a flowerbed
  ten red flowers
  a statue
  a sign

>drop 23 red flowers
Only ten of those are available.

>examine red flowers
You can't use multiple objects with that verb.

>examine red flower
This is an Adonis Flower.

>where can i go
That's not a verb I recognise.

>x
What do you want to examine?

>fly
You can't see any such thing.

>drop flowerbed
Dropped.

>put statue in flowerbed
You put the statue into the flowerbed.

>take flowerbed
Taken.

>i
You are carrying:
  a flowerbed
    a statue
  ten red flowers
  a sign

>put flowerbed
What do you want to put the flowerbed in?

>in a red flower
I only understood you as far as wanting to put the flowerbed in inside.

>drop flowerbed
Dropped.

>take flowerved
You can't see any such thing.

>take flowerved
You can't see any such thing.

>take flowerbed
Taken.

>drop 1 red flower
Dropped.

>l
Secret Garden
You are in the Secret Garden

You can see a red flower here.

>put flowerbed in red flower
That can't contain things.

>:(
That's not a verb I recognise.

>take flower
That was the last red flower. There are no more in this garden.

>xc
That's not a verb I recognise.

>c
That's not a verb I recognise.

>x
What do you want to examine?

>l
Secret Garden
You are in the Secret Garden

>i
You are carrying:
  ten red flowers
  a flowerbed
    a statue
  a sign

>put flowerbed in sign
That can't contain things.

>put sign in flowerbed
You put the sign into the flowerbed.

>i
You are carrying:
  ten red flowers
  a flowerbed
    a sign
    a statue

>eat 1 red flower
That's plainly inedible.

>eat flowerbed
That's plainly inedible.

>eat statue
That's plainly inedible.

>drink flower
There's nothing suitable to drink here.

>put sign into statue
(first taking the sign)
That can't contain things.

>i
You are carrying:
  a sign
  ten red flowers
  a flowerbed
    a statue

>put sign into flowerved
You can't see any such thing.

>put sign into flowerbed
You put the sign into the flowerbed.

>u
Throne Room
Home to the King of Paphos, Pygmalion.

You can see Cinyras here.

>i
You are carrying:
  ten red flowers
  a flowerbed
    a sign
    a statue

>u
You can't go that way.

>i
You are carrying:
  ten red flowers
  a flowerbed
    a sign
    a statue

>l
Throne Room
Home to the King of Paphos, Pygmalion.

You can see Cinyras here.

>examine Cinyras
You see nothing special about Cinyras.

>take Cinyras
I don't suppose Cinyras would care for that.

>kill Cinyras
Violence isn't the answer to this one.

>put Cinyras into flowerbed
(first taking Cinyras)
I don't suppose Cinyras would care for that.

>i
You are carrying:
  ten red flowers
  a flowerbed
    a sign
    a statue

>change sign to hi pizza
That's not a verb I recognise.

>write on sign pizza
That's not a verb I recognise.

>go to paphos
You can't see any such thing.

>exit
But you aren't in anything at the moment.

>d
Secret Garden
You are in the Secret Garden

>u
Throne Room
Home to the King of Paphos, Pygmalion.

You can see Cinyras here.

>up
You can't go that way.

>doen
That's not a verb I recognise.

>down
Secret Garden
You are in the Secret Garden

>up
Throne Room
Home to the King of Paphos, Pygmalion.

You can see Cinyras here.

>d
Secret Garden
You are in the Secret Garden

>e
Divine Cell 4
You see the gods sleeping

You can see Aphrodite and Hephaestus here.

>w
Secret Garden
You are in the Secret Garden

* * *

>d
(first opening the trapdoor)
It seems to be locked.

>take red flower
You picked up a red flower.

>d
You can't go down from here.

>x lake
You see nothing special about the lake.

>d
You can't go down from here.

>go in lake
You can't. All you can see is dirty water.

>i
You are carrying:
  a red flower

* * *

>d
(first opening the trapdoor)
It seems to be locked.

>take the club
You picked up a Heracles' Club.

Olympus Hall Celebration Scene ended

* * *

>d
(first opening the trapdoor)
It seems to be locked.

>u
You can't go that way.

>go in trapdoor
(first opening the trapdoor)
It seems to be locked.

>enter trapdoor
(first opening the trapdoor)
It seems to be locked.

>x trapdoor
The trapdoor is locked now.

>actions
Actions listing on.

>enter trapdoor
[entering the trapdoor]
[(1) going the trapdoor]
(first opening the trapdoor)
[(2) opening the trapdoor - silently]
It seems to be locked.
[(2) opening the trapdoor - silently - failed the can't open what's locked rule]

[(1) going the trapdoor - failed the can't go through closed doors rule]

[entering the trapdoor - failed the convert enter door into go rule]

* * *

>d
(first opening the trapdoor)
It seems to be locked.

>x lake
It's a beautiful lake full of colourfull waterlilies.

>look lake
You see nothing special about the lake.

>l
Secret Garden
You are in the Secret Garden

You see a lake.

A heavy looking gate that seems to lead to the next room is on the eastern side of the garden, its view obstructed by vines and flowers.

You find yourself before a flowerbed with intense red flowers...

a flowerbed with beautiful purple flowers...

a flowerbed with vibrant yellow flowers...

and a flowerbed with pretty white flowers.

In the garden you see a statue of a beautiful man.

You can also see a container B (empty), a container C (empty) and a container D (empty) here.

>d
You can't go down from here.

* * *

>x lake
It's a beautiful lake full of colourfull waterlilies.

>take red flower
You picked up a red flower.

>x lake
Poseidon's Power flows through your vains. You can clearly see an underwather path. You wonder if it actually leads you where you should be.

>d
You look at the lake. Maybe you can go down through there.

You swim through the waters.

You can't go that way.

>l
Secret Garden
You are in the Secret Garden. You can see red, purple, yellow and white flowers planted in some flowerbeds. In your right you can see some golden amphorae. In the middle of the garden you see an enormous tree with a cavity in the middle. You see lake with shells in the shore. A heavy looking gate that seems to lead to the next room is on the eastern side of the garden, its view mostly obstructed by vines and flowers. In the garden you see a statue of a beautiful man.

* * *

>x lake
Poseidon's Power flows through your vains. You can clearly see an underwather path. You wonder if it actually leads you where you should be.

>enter lake
You swim through the waters.

Divine Cell 4
You see the gods sleeping

 You can see a body of water in the ceiling. 

 The puzzle door from before is behind you.

You can also see Aphrodite and Hephaestus here.

>u
Secret Garden
You are in the Secret Garden. You can see red, purple, yellow and white flowers planted in some flowerbeds. In your right you can see some golden amphorae. In the middle of the garden you see an enormous tree with a cavity in the middle

 You see a lake. On its shore you see some seashells. 

A heavy looking gate that seems to lead to the next room is on the eastern side of the garden, its view mostly obstructed by vines and flowers.

In the garden you see a statue of a beautiful man.

>d
You swim through the waters.

Divine Cell 4
You see the gods sleeping

 You can see a body of water in the ceiling. 

 The puzzle door from before is behind you.

You can also see Aphrodite and Hephaestus here.

* * *

>e
(first opening the puzzle gate)
It isn't something you can open.

>e
(first opening the puzzle gate)
It isn't something you can open.

>test me
(Testing.)

>[1] put red flower in hands
(first taking the red flower)
You picked up a red flower.

You put the red flower into the hands.

>[2] put purple flower in b
(first taking the purple flower)
You picked up a purple flower.

You put the purple flower into the container B.

>[3] put yellow flower in c
(first taking the yellow flower)
You picked up a yellow flower.

You put the yellow flower into the container C.

>[4] put white flower in d
(the container D)
(first taking the white flower)
You picked up a white flower.

You put the white flower into the container D.

You hear the sound of the gate opening
>[5] x gate
The puzzle gate is now open.

>go in gate
Divine Cell 4
You see the gods sleeping

You can see a puzzle gate, Aphrodite and Hephaestus here.

* * *

>eat red flower
Yuck. Why would you make me eat that Ema?

* * *

>enter boat
You should pay the ferryman first. One obol is the standard price.

>enter boat
You should pay the ferryman first. One obol is the standard price.

>give obol to charon
You give Obol to Charon.

The ferryman accepts the token and signals you to jump into the boat. With slow and certain movements, he leads the boat down the dangerous stream, into the opening of a natural cave. You arrive at the Underworld.

>[enter]
Elysial Fields
You can see a Charon's boat here.

>scenes
Scene 'Entire Game' playing (for 3 mins now)
Scene 'Charon Ride In Scene' ended
(Scene monitoring now switched on. Type "scenes off" to switch it off again.)

>i
You are carrying nothing.

>showme
Elysial Fields - room
    Charon's boat - closed door
    yourself - woman

>u
(first opening the Charon's boat)
It isn't something you can open.

>x charon
You can't see any such thing.

* * *

>[enter]
Elysial Fields
You can see a Charon's boat here.

I beg your pardon?

>showme
Elysial Fields - room
    Charon's boat - open door
    yourself - woman

>x charon
You can't see any such thing.

>scenes
Scene 'Entire Game' playing (for 2 mins now)
Scene 'Charon Ride In Scene' playing (for 1 mins now)
(Scene monitoring now switched on. Type "scenes off" to switch it off again.)

>i
You are carrying nothing.

>d
Asphodel Meadows
You can see a broken bridge and an Aria here.

[Scene 'Heracles in Asphodel Scene' begins]

>u
Elysial Fields
You can see a Charon's boat here.

>u
East of Ephyra
You can see a Charon's boat and Charon here.

* * *

>enter bridge
You can't see any such thing.

>d
Elysial Fields

>d
Asphodel Meadows
You can see a broken bridge and an Aria here.

>enter bridge
You can't cross the bridge, it's broken.

>go in bridge
You can't cross the bridge, it's broken.

>go to bridge
You can't see any such thing.

>take aria
You picked up a Aria.

>go in bridge
You put on Hermes' sandals and fly over the broken bridge.

Tartarus
You can see a broken bridge here.

* * *

>enter sea
The nereides agree to take you to the sunken Temple .

Temple of Poseidon
Description of temple of poseidon.

>d
Divine Cell 2
yrrgs

* * *

>enter sea
The nereides agree to take you to the sunken Temple .

Temple of Poseidon
Description of temple of poseidon.

>i
You are carrying:
  an aria

>showme AmphitriteIsCaml
There seems to be no such object anywhere in the model world.

>showme AmphitriteIsCalm
There seems to be no such object anywhere in the model world.

>showme
Sounio Beach - room
    sea - open door
    yourself - woman
        aria
    nereides - woman
    Aktaia
    Erato
    Ploto
    angry nereida - woman

* * *

>enter statue
It seems like you might be missing two keys.

>enter door
It seems like you might be missing two keys.

>push statue
It seems like you might be missing two keys.

* * *

>examine adonis
You see nothing special about Adonis.

* * *

>examine amaranths
You see nothing special about Amaranths.

>pick up one amaranth
You can't see any such thing.

* * *

>examine box
You see nothing special about Magic Box.

>take key
Taken.

>unlock box
(with the Magic Key)
You unlock Magic Box.

>look
Mountain Olympus Hall
Mountain Olympus Hall Description

You see your husband here.

 You see a closed box.

table is here

>open box
You open Magic Box, revealing a Hercule's Club.

>look
Mountain Olympus Hall
Mountain Olympus Hall Description

You see your husband here.

You see a box. Inside it there's a club. 

table is here

>inventory
You are carrying:
  a Magic Key

>take club
Taken.

>inventory
You are carrying:
  a Hercule's Club
  a Magic Key

>examine club
You found Hercules'Club! It's heavy, but nothing you can't handle.

* * *

>examine dvgate
The gate is locked.

>examine rock
You see nothing special about the rock.

>eat rock
That's plainly inedible.

>smell rock
It smells neutral.

>examine walls
On the temple walls, the legendary tale of Cadmus is immortalized: he bravely confronts the fearsome Dragon of Ismenus, guardian of Ares" sacred spring, slaying the beast with a rock on the head. After sacrificing to Athena, guided by her wisdom, he buries the dragon's teeth into the earth, from which arise the Spartoi-warriors born from the dragon's teeth, who soon battle amongst themselves.

>examine dragon statue
The statue's mouth is closed.

>open mouth
It isn't something you can open.

>smell dragon statue
It smells neutral.

>eat dragon statue
That's plainly inedible.

>examine kadema altar
You can't see any such thing.

>examine kadmea altar
On the Kadmea altar is a sacrificial plate (empty).

>examine pan1
You see nothing special about the pan1.

>examine pan2
You see nothing special about the pan2.

>examine pan3
You see nothing special about the pan3.

>examine pan4
You see nothing special about the pan4.

>smell pan5
It smells neutral.

>examin pan6
That's not a verb I recognise.

>eat pan1
That's plainly inedible.

>take pan1
That's fixed in place.

>take pan2
That's fixed in place.

>take dragon statue
That's fixed in place.

>take walls
That's fixed in place.

>eat rock
That's plainly inedible.

>take rock
You picked up a rock.

>examine chess
You can't see any such thing.

>examine chess pieces
You can't see any such thing.

>examine sign
It says: The key to passage lies from the lightest touch to the heaviest step.

>i
You are carrying:
  a rock

>put rock pan6
I didn't understand that sentence.

>put rock on pan6
You put the rock on the pan6.

>examine dvgate
The gate is locked.

>take rock
You picked up a rock.

>i
You are carrying:
  a rock

>examine pan6
You see nothing special about the pan6.

>examine dragon statue
The statue's mouth is closed.

>put rock on dragon statue
Putting things on dragon statue would achieve nothing.

>put rock on pan6
You put the rock on the pan6.

>examien dragon statue
That's not a verb I recognise.

>examine dragon statue
The statue's mouth is closed.

>take rock
You picked up a rock.

>put rock on pan1
You put the rock on the pan1.

>examine dragon statue
The statue's mouth is closed.

* * *

>take rock
You picked up a rock.

>put rock on dragon statue mouth
I only understood you as far as wanting to put the rock on dragon statue.

>put rock on dragon head
You put the rock on the dragon head.

The statue's mouth opened.

>examine mouth
In the dragon mouth are six dragon teeth.

>examine teeth
You can't use multiple objects with that verb.

>examine tooth 1
You can't see any such thing.

>examine dragon statue
You see 6 tooth inside the statue's mouth.

>take teeth
dragon tooth: You picked up a dragon tooth.
dragon tooth: You picked up a dragon tooth.
dragon tooth: You picked up a dragon tooth.
dragon tooth: You picked up a dragon tooth.
dragon tooth: You picked up a dragon tooth.
dragon tooth: You picked up a dragon tooth.

>i
You are carrying:
  six dragon teeth

>take rock
You picked up a rock.

The statue's mouth closed

>put rock on pan6
You put the rock on the pan6.

>put a dragon tooth on pan2
You put the dragon tooth on the pan2.

>put two dragon teeth on pan3
dragon tooth: Done.
dragon tooth: Done.

>take teeth
dragon tooth: You picked up a dragon tooth.
dragon tooth: You picked up a dragon tooth.
dragon tooth: You picked up a dragon tooth.

>take rock
You picked up a rock.

>take brick
You can't see any such thing.

>take brick from walls
You can't see any such thing.

>examine dvgate
The gate is locked.

>examine room
You can't see any such thing.

>look
Kadmea
on the walls you can see the story of Kadmos, who slayed the Dragon of Ismenus and burried his teeth for the Spartoi to sprink from the ground. In front of you is a stone dragon statue, and a big chess board with some chess pieces already on top. You can see a sacrificial plate on top of the altar. The dvgate has a sign on it.

You can see a dvgate, a walls, dragon statue, a Kadmea altar (on which is a sacrificial plate (empty)), a pan1, a pan2, a pan3, a pan4, a pan5, a pan6 and a scale here.

>take chess pieces
You can't see any such thing.

>examine kadmea altar
On the Kadmea altar is a sacrificial plate (empty).

>take kadmea altar
That's fixed in place.

>take sacrificial plate
That's fixed in place.

>examine sacrificial plate
The sacrificial plate is empty.

>put dragon tooth on sacrificial plate
Putting things on the sacrificial plate would achieve nothing.

>put dragon tooth in sacrificial plate
You put the dragon tooth into the sacrificial plate.

>examine sacrificial plate
In the sacrificial plate is a dragon tooth.

>examine kadmea altar
On the Kadmea altar is a sacrificial plate (in which is a dragon tooth).

>examin dvgate
That's not a verb I recognise.

>examine dvgate
The gate is locked.

>take dragon tooth
You picked up a dragon tooth.

>examine scale
The scale is currently centered.

>put rock on scale
Putting things on the scale would achieve nothing.

>put rock on left pan
You put the rock on the left pan.

>put dragon tooth on right pan
You put the dragon tooth on the right pan.

>examine scale
The scale is currently centered.

>take dragon tooth
You picked up a dragon tooth.

>take rock
You picked up a rock.

>put dragon teeth in sacrificial altar
I only understood you as far as wanting to put those things in the sacrificial plate.

>put dragon teeth in sacrificial plate
dragon tooth: Done.
dragon tooth: Done.
dragon tooth: Done.
dragon tooth: Done.
dragon tooth: Done.
dragon tooth: Done.

The dragon teeth are syphoned into the altar and a compartment door opens, exposing 6 weights.

>take weights
weight1: You picked up a weight1.
weight2: You picked up a weight2.
weight3: You picked up a weight3.
weight4: You picked up a weight4.
weight5: You picked up a weight5.
weight6: You picked up a weight6.

>put weight1 on left scale
I only understood you as far as wanting to put the weight1 on the left pan.

>put weight1 on left pan
You put the weight1 on the left pan.

>put weight2 on right pan
You put the weight2 on the right pan.

>eat scale
That's plainly inedible.

>examine scale
The scale is currently right-leaning.

>take weight1
You picked up a weight1.

>put weight3 on left pan
You put the weight3 on the left pan.

>examine scale
The scale is currently left-leaning.

>take weight2
You picked up a weight2.

>put weight4 on right pan
You put the weight4 on the right pan.

>examine scale
The scale is currently right-leaning.

>take weight3
You picked up a weight3.

>put weight5 on left pan
You put the weight5 on the left pan.

>examine scale
The scale is currently left-leaning.

>take weight4
You picked up a weight4.

>put weight6 on right pan
You put the weight6 on the right pan.

>x scale
The scale is currently right-leaning.

>take weight6
You picked up a weight6.

>put weigh6 on pan6
You can't see any such thing.

>put weight6 on pan6
You put the weight6 on the pan6.

>put weight1 on right pan
You put the weight1 on the right pan.

>put weight2 on left pan
You put the weight2 on the left pan.

>examine scale
The scale is currently left-leaning.

>take weight1
You picked up a weight1.

>take weight2
You picked up a weight2.

>put weight1 on pan1
You put the weight1 on the pan1.

>put weight2 on pan2
You put the weight2 on the pan2.

>put weight3 on pan3
You put the weight3 on the pan3.

>put weight4 on pan4
You put the weight4 on the pan4.

>eat weight5
That's plainly inedible.

>smell weight5
It smells neutral.

>put weight5 on pan5
(first taking the weight5)
You picked up a weight5.

You put the weight5 on the pan5.

You hear the sound of the gate mechanism unlocking

>enter gate
(first opening the dvgate)

Divine Cell 1
You can see a dvgate here.

* * *

>examine flower
You can't see any such thing.

>examine flowers
You see nothing special about 10 Red Flowers.

>take flower
You can't see any such thing.

* * *

>examine flower
You can't see any such thing.

>examine red flower
I only understood you as far as wanting to examine 10 red flowers.

* * *

>examine flowerbed
You can see some red flowers in a flowerbed

In the flowerbed are ten red flowers.

* * *

>examine red flowers
You can't use multiple objects with that verb.

>examine adonis
You see nothing special about Adonis.

>colour adonis
That's not a verb I recognise.

* * *

>examine red flower
This is an Adonis Flower.

>take adonis flower
You picked up a red flower.

>i
You are carrying:
  a red flower

>take 9 red flowers
red flower: You picked up a red flower.
red flower: You picked up a red flower.
red flower: You picked up a red flower.
red flower: You picked up a red flower.
red flower: You picked up a red flower.
red flower: You picked up a red flower.
red flower: You picked up a red flower.
red flower: You picked up a red flower.
red flower: That was the last red flower. There are no more in this garden.

>i
You are carrying:
  ten red flowers

* * *

>examine red flowers
You can't use multiple objects with that verb.

>examine the red flowers
You see nothing special about the red flowers.

>pick up one red flower
I only understood you as far as wanting to pick up the red flowers.

>pick up red flower
I only understood you as far as wanting to pick up the red flowers.

>pick up red flowers
Taken.

>i
You are carrying:
  some red flowers

>examine red flowers
You see nothing special about the red flowers.

>examine red flower
I only understood you as far as wanting to examine the red flowers.

I beg your pardon?

* * *

>examine sign
The sign is made of marble. The inscription on it reads: Painful memories of our love surround this place.

>examine statue
The statue depicts a beautiful man. He's holding a basket. It's empty.

* * *

>examine statue
The statue depicts a beautiful man. He's holding a basket. It's empty.

>examine basket
The basket is empty.

>pick up amaranths
Taken.

>put amaranths in basket
You put the Amaranths into the basket.

>examine basket
In the basket are some Amaranths.

>examine statue
The statue depicts a beautiful man. He's holding a basket. It's empty.

>examine statue
The statue depicts a beautiful man. He's holding a basket. It's empty.

On the statue is a basket (empty).

>examine statue
The statue depicts a beautiful man. He's holding a basket. It's empty.

On the statue is a basket (empty).

* * *

>examine statue
The statue depicts a beautiful man. He's holding a basket. It's empty.

>look
Secret Garden
You see many flowers

Painful memories of our love surround this place.

You can also see a statue here.

>examine statue
It looks like he should be holding something.

* * *

>exit
Acropolis

>go in prytneion
You can't see any such thing.

>go in prytaneion
You went into the prytaneion
Prytaneion
TODO simple description

You can see a first torch, a second torch, a third torch, a fourth torch, a fifth torch, a sixth torch, a seventh torch, an eighth torch, a ninth torch, a tenth torch, an eleventh torch, a twelfth torch, a thirteenth torch, a fourteenth torch, a fifteenth torch, a sixteenth torch, an empty scroll, a wax tablet, a text scroll and a parchment here.

>light firct torch
You can't see any such thing.

>light first torch
You picked up the portable torch.

You lighted the first torch using the portable torch.

>i
You are carrying:
  a portable torch

>put out first torch
You picked up the snuffer.

You put off the first torch with the flame snuffer.

>i
You are carrying:
  a snuffer
  a portable torch

>go out
You leave the portable torch and the snuffer where you found them.

Acropolis

>i
You are carrying nothing.

* * *

>gave club to heracles
That's not a verb I recognise.

>give club to heracles
(first taking the Heracles' Club)
You picked up a Heracles' Club.

He smiles to you. "Thank you my dearest."

* * *

>get in amphora
You don't think you will fit there.

>take amphora
It's too heavy for you.

>smell amphorae
They smell of flower extracts and herbs.

>smell amphora
It smells of flower extracts and herbs.

* * *

>get in boat
You should pay the ferryman first. One obol is the standard price.

>give charon an obol
You give Obol to Charon.

The ferryman accepts the token and signals you to jump into the boat. With slow and certain movements, he leads the boat down the dangerous stream, into the opening of a natural cave. You arrive at the Underworld.

>[enter]
You should pay the ferryman first. One obol is the standard price.

I beg your pardon?

* * *

>get out
Acropolis

>go in prytaneion
You went into the prytaneion
Prytaneion
You step into the open hall of the Prytaneion, the administrative heart of Athens. In the center of the room you see the sacred hearth dedicated to Hestia, its warm glow illuminating the room. The flames burn steadily, their smoke rising in delicate spirals before disappearing through a square opening in the roof above. Beside the hearth lies a single hand torch, accompanied by a fire snuffer.

Just beyond the hearth, there is a small dining area. A large table made of pine, surrounded by several chairs, stands atop an elegant carpet, likely reserved for official dinners and gatherings. Scattered across the table are an empty scroll, a wax tablet, a papyrus scroll and a parchment scroll, remnants of a recent meeting, perhaps.

Eight torches on either side of the hearth are placed on the ground, forming a semicircle around the dining area. The torches are all put out, from the first-the far left one-to the sixteenth-the far right one.

The rest of the building remains inaccessible, since the doors lead to the private quarters of the prytaneis and thus are firmly locked, leaving the main hall as the only accessible space.

>enter door
You can't see any such thing.

>enter trapdoor
You can't see any trapdoor.

* * *

>give charon 1 obol
You give Obol to Charon.

The ferryman accepts the token and signals you to jump into the boat. With slow and certain movements, he leads the boat down the dangerous stream, into the opening of a natural cave. You arrive at the Underworld.

>[enter]
Elysian Fields
You can see a Charon's boat here.

>d
Asphodel Meadows
You can see a broken bridge, an Aria and a plaque here.

>l
Asphodel Meadows
You can see a broken bridge, an Aria and a plaque here.

>showme
Asphodel Meadows - room
    yourself - woman
    broken bridge - closed door
    Aria
    plaque

>x plaque
Only the ones who give up all hope of returning shall pass.

Heracles becomes serious. "This means to pass we need to give up our immortality and become mortal." His face softens. "My dearest Hebe... we will do this together. Are you ready?"

Please answer yes or no.

>y
Heracles holds your hands. "Let's go my dearest. It'll be fine."

Darkness
It is pitch dark, and you can't see a thing.

>i
You are carrying nothing.

* * *

>give club to heracles
(first taking Heracles' Club)
You picked up the Club of Heracles.

He smiles at you. "Thank you my dearest."

>[enter]
Suddenly, an eerie silence fell over the festive night. The singing and dancing ceased, as if an unseen hand had stilled them. For a brief moment, you felt the coldness of the mountain air, a stark contrast to the pleasant breeze that had enveloped you moments before. A sense of foreboding fills you as you become aware that all eyes are turned behind you. You lock eyes with Heracles, both of you sharing a look of worry. With a growing sense of dread, you turned to see what had drawn everyone's attention.

"Oh dear, please, do not let my presence taint your insignificant gathering. Carry on as you were."

The voice was unmistakable, deep and resonant, carrying an ancient power that sent shivers down your spine. It was Kronos. So much time has passed since our triumph in the War of Titans- the Titanomachy. How did he manage to escape Tartaros?

The sight of the Titan, towering and menacing, shrouded in shadows, struck fear into the hearts of all present. You start to feel the ichor in your divine veins turn cold, as if time itself was freezing. The gods, normally so mighty and formidable, stand paralyzed in shock. Nothing moves. In a heartbeat, you break free from the daze and come to your senses. Your next actions have never been more certain. It's now or never.

You grab Heracle's club out of his hands and leap towards Kronos. Then you feel yourself slipping into unconciousness.

>[enter]
Garden of Hesperides

From here you can sail to: 
→ Piraeus
→ Sounio
→ Aulis
→ Paphos

You can see Eternal Chalice of Nectar, Aigle, Arethousa, Erytheia and Hesperie here.

I beg your pardon?

>l
Garden of Hesperides
You slowly regain consciousness, greeted by the soft rustling of leaves of a tranquil garden. As your eyes flutter open, you find yourself surrounded by four enchanting numphs. Their expressions are a mix of deep concern and immense relief, as if they've been holding their breath waiting for this moment. You instantly recognise Aigle, Arethousa, Erytheia and Hesperie, the nymphs of the evening known as Hesperides, guardians of the orchard of the Garden of Hesperides.

"Hebe, it's been two weeks!" Arethousa exclaims, her voice a blend of worry and joy. "We were all so anxious for you to wake up."

With gentle hands, the nymphs help you to sit up, their embraces warm and comforting. The familiar scent of the Garden of Hesperides fills your senses, grounding you in the safety of their presence.

Aigle, her expression displaying a hint of urgency, leans in. "You should get moving now that you're awake. There are disturbing rumors that Kronos has imprisoned the gods and is attempting to free his brothers from Tartaros. You're the only goddess we've seen show any signs of activity lately."

Erytheia nods in agreement. "We don't have many details, but the Oracle of Delphi might have the answers you need. It would be wise to seek her counsel."

Hesperie steps forward, holding out something. It is the Eternal Chalice of Nectar, once your symbol of duty as the cupbearer of the gods before the events that led to Ganymedes taking on that role. Her eyes are earnest as she places the chalice in your hands.

"You might need this," Hesperie says softly. "Without nectar or ambrosia, gods can lose their immortality and eternal youth. You know this better than anyone."

The Hesperides embrace you one last time. "Good luck, Hebe!" they all say in unison. "We will be here, supporting you in any way we can." 

You can see Eternal Chalice of Nectar, Aigle, Arethousa, Erytheia and Hesperie here.

* * *

>[enter]
Garden of Hesperides

From here you can sail to: 
→ Piraeus
→ Sounio
→ Aulis
→ Paphos

You can see Eternal Chalice of Nectar, Aigle, Arethousa, Erytheia and Hesperie here.

>[enter]
Garden of Hesperides
You slowly regain consciousness, greeted by the soft rustling of leaves of a tranquil garden. As your eyes flutter open, you find yourself surrounded by four enchanting ny+mphs. Their expressions are a mix of deep concern and immense relief, as if they've been holding their breath waiting for this moment. You instantly recognise Aigle, Arethousa, Erytheia and Hesperie, the nymphs of the evening known as Hesperides, guardians of Hera's orchard.

"Hebe, it's been almost two weeks!" Arethousa exclaims, her voice a blend of worry and joy. "We were all so anxious for you to wake up."

With gentle hands, the nymphs help you to sit up, their embraces warm and comforting. The familiar scent of the Garden of Hesperides fills your senses, grounding you in the safety of their presence.

Aigle, her expression displaying a hint of urgency, leans in. "You should get moving now that you're awake. There are disturbing rumors that Kronos has imprisoned the gods and is attempting to free his brothers from Tartaros. You're the only goddess we've seen show any signs of activity lately."

Erytheia nods in agreement. "We don't have many details, but the Oracle of Delphi might have the answers you need. It would be wise to seek her counsel."

Hesperie steps forward, holding out something. It is the Eternal Chalice of Nectar, once your symbol of duty as the cupbearer of the gods before the events that led to Ganymedes taking on that role. Her eyes are earnest as she places the chalice in your hands.

"You might need this," Hesperie says softly. "Without nectar or ambrosia, gods can lose their immortality and eternal youth. You know this better than anyone."

The Hesperides embrace you one last time. "Good luck, Hebe!" they all say in unison. "We will be here, supporting you in any way we can."

I beg your pardon?

>l
Garden of Hesperides
The Garden of the Hesperides is a mythical paradise, an otherworldly oasis hidden in the middle of the Mediterranean, where the air is perpetually filled with the sweet fragrance of blooming flowers and the gentle hum of bees.

In the heart of the garden stands the sacred tree of the Hesperides, its branches heavy with golden apples that gleam like captured sunlight. The apples, used to make nectar, hang among rich green leaves, guarded by the the Hesperides, the nymphs of the evening and daughters of the night. The nymphs are Aigle, Arethousa, Erytheia and Hesperie.

The story goes that Gaia gifted Hera with branches of golden apples as a wedding present, and Hera, deeply admiring them, begged Gaia to plant them in her garden.

From here you can sail to: 
→ Piraeus
→ Sounio
→ Aulis
→ Paphos

>sail to aulis
You sail to the Port of Aulis.

Port of Aulis
To the west you can see the city of Aulis. 

From here you can sail to: 
→ Sounio
→ Garden of Hesperides

>w
Agora of Aulis
You can see the Port of Aulis in the east and the Gates of Aulis in the south.

>s
Gates of Aulis
To the north you can see the town of Aulis. 

From here you can travel to: 
→ Thebes
→ Athens
→  Delphi
→ Ephyra
→ Mount Olympus

>travel to delphi
You travel to the Gates of Delphi.

Gates of Delphi
To the south of Delphi is the Oracle of Delphi.

From here you can travel to: 
→ Thebes 
→ Athens
→ Aulis
→ Ephyra
→ Mount Olympus

>n
You can't go that way.

>s
South of Delphi
From here you can see the the Oracle of Delphi, the sacred sanctuary surrounded by towering cliffs and overlooking the olive groves of the Valley of Delphi. The approach to the main temple is marked by a winding path, the Sacred Way, which is lined with treasures, monuments and statues left by cities and individuals in gratitude for prophecies.

>showme
South of Delphi - room
    yourself - woman
        Eternal Chalice of Nectar
        Heracles' Club
    cliff
    grove
    main temple
    Sacred Way
    treasure
    monument
    delphi statue
        marble base (part of delphi statue)
    oracle of delphi - inroom

>go in oracle of delphi
You go into the oracle of delphi.

Oracle of Delphi
As you step into the main temple of the area, you are greeted by the scent of burning incense, sweet and heady, with smoke curling upwards in spirals towards the vaulted ceiling.

Tall, imposing columns line the hall, casting dancing shadows on the walls by the flickering light of oil lamps. There, scenes of Apollo's journeys are etched into the marble, their details so fine they seem almost alive.

Ahead, at the far end of the hall, you see the adyton, the innermost chamber. It is veiled in semi-darkness, a place of deep reverence and mystery. The sacred omphalos stone, marking the navel of the world, stands at the center, draped in garlands and offerings left by travelers. Beyond it, shrouded in the shadows, lies the seat of the oracle, where the Pytheia sits, ready to deliver her prophecies.

>out
South of Delphi
From here you can see the the Oracle of Delphi, the sacred sanctuary surrounded by towering cliffs and overlooking the olive groves of the Valley of Delphi. The approach to the main temple is marked by a winding path, the Sacred Way, which is lined with treasures, monuments and statues left by cities and individuals in gratitude for prophecies.

>go to oracle of delphi
You can't see any such thing.

>go in oracle
You go into the oracle of delphi.

Oracle of Delphi
As you step into the main temple of the area, you are greeted by the scent of burning incense, sweet and heady, with smoke curling upwards in spirals towards the vaulted ceiling.

Tall, imposing columns line the hall, casting dancing shadows on the walls by the flickering light of oil lamps. There, scenes of Apollo's journeys are etched into the marble, their details so fine they seem almost alive.

Ahead, at the far end of the hall, you see the adyton, the innermost chamber. It is veiled in semi-darkness, a place of deep reverence and mystery. The sacred omphalos stone, marking the navel of the world, stands at the center, draped in garlands and offerings left by travelers. Beyond it, shrouded in the shadows, lies the seat of the oracle, where the Pytheia sits, ready to deliver her prophecies.

>x pytheia
Pytheia, the high priestess of the Oracle of Delphi, appears draped in flowing robes of shimmering white and deep purple, her face partially covered by a delicate veil of fine silk flowing from her hair. Her demeanor is both serene and enigmatic, her eyes reflecting a depth of wisdom as she sits on her tripod, surrounded by the faint, otherworldly aroma of incense.

>out
South of Delphi
From here you can see the the Oracle of Delphi, the sacred sanctuary surrounded by towering cliffs and overlooking the olive groves of the Valley of Delphi. The approach to the main temple is marked by a winding path, the Sacred Way, which is lined with treasures, monuments and statues left by cities and individuals in gratitude for prophecies.

>n
Gates of Delphi
To the south of Delphi is the Oracle of Delphi.

From here you can travel to: 
→ Thebes 
→ Athens
→ Aulis
→ Ephyra
→ Mount Olympus

>travel to ephyra
You travel to the Gates of Ephyra.

Gates of Ephyra
To the west you can see the town of Ephyra. 

From here you can travel to: 
→ Mount Olympus 
→ Athens
→ Thebes
→ Aulis
→ Delphi

>n
North of Ephyra

>l
North of Ephyra

>go to necromanteion
You can't see any such thing.

>showme
North of Ephyra - room
    yourself - woman
        Eternal Chalice of Nectar
        Heracles' Club
    necromanteion - inroom

>enter necromanteion
You go into the necromanteion.

Necromanteion
As you step into the Necromanteion, the air is filled with the scent of incense and the faint aroma of past offerings. The dim light of  torches casts flickering shadows on the stone walls and floor, creating a somber yet oddly comforting ambiance.

The darkness here is not forbidding, but rather a familiar shroud, welcoming you into a realm you know well: the domain of Hades and Persephone, a place where life and death intertwine in an eternal dance, and where you is an honored guest, not an intruder.

The stone passageway, worn smooth by countless travelers, guides you deeper into the sacred site. Ahead, you can see the central chamber, where the Necromanteion Altar stands, carved from black marble and gleaming faintly in the torchlight. A few offerings still rest upon it, left by the faithful.

As you approach the altar, the high priestess approaches you, her robes flowing like a shadowy river as she tends to the sacred rites. She acknowledges your presence with a serene nod.

>i
You are carrying:
  Eternal Chalice of Nectar
  Heracles' Club

>put club on altar
You shouldn't sacrifice something that isn't yours to sacrifice.

>sacrifice club
You shouldn't sacrifice something that isn't yours to sacrifice.

>sacrifice chalice
You will need this if you want to save your family. Better keep it

* * *

>[enter]
Garden of Hesperides

From here you can sail to: 
→ Piraeus
→ Sounio
→ Aulis
→ Paphos

You can see Eternal Chalice of Nectar, Aigle, Arethousa, Erytheia and Hesperie here.

>sail to piraeus
You sail to the Port of Piraeus.

Port of Piraeus
From here you can sail to: 
→ Paphos
→ Garden of Hesperides

>ne
Agora of Athens

>e
Acropolis

>go in prytaneion
You went into the prytaneion
Prytaneion
TODO simple description

You can see a porta, a portable torch, a first torch, a second torch, a third torch, a fourth torch, a fifth torch, a sixth torch, a seventh torch, an eighth torch, a ninth torch, a tenth torch, an eleventh torch, a twelfth torch, a thirteenth torch, a fourteenth torch, a fifteenth torch, a sixteenth torch, an empty scroll, a wax tablet, a text scroll and a parchment here.

>light first torch
You lighted the first torch.

>put off first torc
I only understood you as far as wanting to put off the first torch.

>put off first torch
You put off the first torch.

>showme first torch
first torch - first torch
location: in Prytaneion
unlit, inedible, portable; singular-named, improper-named
description: none
initial appearance: none
smell: neutral
printed name: "first torch"
printed plural name: "first torches"
indefinite article: none
list grouping key: none

>blow out first torch
The first torch is already unlit.

>blow out hearth
The hearth flames are too strong; you can't simply put them out!

I beg your pardon?

>showme hearth
hearth - thing
location: in Prytaneion
lit, inedible, fixed in place, scenery; singular-named, improper-named
description: none
initial appearance: none
smell: neutral
printed name: "hearth"
printed plural name: none
indefinite article: none
list grouping key: none

>light hearth
The hearth is already blazing brightly.

* * *

>[enter]
Garden of Hesperides

From here you can sail to: 
→ Piraeus
→ Sounio
→ Aulis
→ Paphos

You can see Eternal Chalice of Nectar, Aigle, Arethousa, Erytheia and Hesperie here.

>sail to pireaus
That noun did not make sense in this context.

>sail
What do you want to sail to?

>piraeus
You sail to the Port of Piraeus.

Port of Piraeus
From here you can sail to: 
→ Paphos
→ Garden of Hesperides

>ne
Agora of Athens

* * *

>e
Acropolis

>go to prytaneion
You can't see any such thing.

>+
That's not a verb I recognise.

* * *

>give heracles club
(first taking the Heracles' Club)
You picked up the Club of Heracles.

He smiles at you. "Thank you my dearest."

>[enter]
Suddenly, an eerie silence fell over the festive night. The singing and dancing ceased, as if an unseen hand had stilled them. For a brief moment, you felt the coldness of the mountain air, a stark contrast to the pleasant breeze that had enveloped you moments before. A sense of foreboding fills you as you become aware that all eyes are turned behind you. You lock eyes with Heracles, both of you sharing a look of worry. With a growing sense of dread, you turned to see what had drawn everyone's attention.

"Oh dear, please, do not let my presence taint your insignificant gathering. Carry on as you were."

The voice was unmistakable, deep and resonant, carrying an ancient power that sent shivers down your spine. It was Kronos. So much time has passed since our triumph in the War of Titans- the Titanomachy. How did he manage to escape Tartaros?

The sight of the Titan, towering and menacing, shrouded in shadows, struck fear into the hearts of all present. You start to feel the ichor in your divine veins turn cold, as if time itself had frozen. The gods, normally so mighty and formidable, stand paralyzed in shock. Nothing moves. In a heartbeat, you break free from the daze and come to your senses. Your next actions have never been more certain. It's now or never.

You grab Heracle's club out of his hands and leap towards Kronos. Then you feel yourself slipping into unconciousness.

>[enter]
Garden of Hesperides

From here you can sail to: 
→ Piraeus
→ Sounio
→ Aulis
→ Paphos

You can see Eternal Chalice of Nectar, Aigle, Arethousa, Erytheia and Hesperie here.

>scenes
Scene 'Entire Game' playing (for 1 mins now)
Scene 'Olympus Hall Celebration Scene' ended
Scene 'Kronos Scene' ended
Scene 'Garden of Hesperides Scene' playing (for 0 mins now)
(Scene monitoring now switched on. Type "scenes off" to switch it off again.)

>l
Garden of Hesperides

From here you can sail to: 
→ Piraeus
→ Sounio
→ Aulis
→ Paphos

You can see Eternal Chalice of Nectar, Aigle, Arethousa, Erytheia and Hesperie here.

[Scene 'Garden of Hesperides Scene' ends]

>l
Garden of Hesperides

From here you can sail to: 
→ Piraeus
→ Sounio
→ Aulis
→ Paphos

You can see Eternal Chalice of Nectar, Aigle, Arethousa, Erytheia and Hesperie here.

>l
Garden of Hesperides

From here you can sail to: 
→ Piraeus
→ Sounio
→ Aulis
→ Paphos

You can see Eternal Chalice of Nectar, Aigle, Arethousa, Erytheia and Hesperie here.

* * *

>give heracles his club
(first taking Heracles' Club)
You picked up the Club of Heracles.

He smiles at you. "Thank you my dearest."

>[enter]
Suddenly, an eerie silence fell over the festive night. The singing and dancing ceased, as if an unseen hand had stilled them. For a brief moment, you felt the coldness of the mountain air, a stark contrast to the pleasant breeze that had enveloped you moments before. A sense of foreboding fills you as you become aware that all eyes are turned behind you. You lock eyes with Heracles, both of you sharing a look of worry. With a growing sense of dread, you turned to see what had drawn everyone's attention.

"Oh dear, please, do not let my presence taint your insignificant gathering. Carry on as you were."

The voice was unmistakable, deep and resonant, carrying an ancient power that sent shivers down your spine. It was Kronos. So much time has passed since our triumph in the War of Titans- the Titanomachy. How did he manage to escape Tartaros?

The sight of the Titan, towering and menacing, shrouded in shadows, struck fear into the hearts of all present. You start to feel the ichor in your divine veins turn cold, as if time itself was freezing. The gods, normally so mighty and formidable, stand paralyzed in shock. Nothing moves. In a heartbeat, you break free from the daze and come to your senses. Your next actions have never been more certain. It's now or never.

You grab Heracle's club out of his hands and leap towards Kronos. Then you feel yourself slipping into unconciousness.

* * *

>[enter]
Garden of Hesperides
You slowly regain consciousness, greeted by the soft rustling of leaves of a tranquil garden. As your eyes flutter open, you find yourself surrounded by four enchanting ny+mphs. Their expressions are a mix of deep concern and immense relief, as if they've been holding their breath waiting for this moment. You instantly recognise Aigle, Arethousa, Erytheia and Hesperie, the nymphs of the evening known as Hesperides, guardians of Hera's orchard.

"Hebe, it's been almost two weeks!" Arethousa exclaims, her voice a blend of worry and joy. "We were all so anxious for you to wake up."

With gentle hands, the nymphs help you to sit up, their embraces warm and comforting. The familiar scent of the Garden of Hesperides fills your senses, grounding you in the safety of their presence.

Aigle, her expression displaying a hint of urgency, leans in. "You should get moving now that you're awake. There are disturbing rumors that Kronos has imprisoned the gods and is attempting to free his brothers from Tartaros. You're the only goddess we've seen show any signs of activity lately."

Erytheia nods in agreement. "We don't have many details, but the Oracle of Delphi might have the answers you need. It would be wise to seek her counsel."

Hesperie steps forward, holding out something. It is the Eternal Chalice of Nectar, once your symbol of duty as the cupbearer of the gods before the events that led to Ganymedes taking on that role. Her eyes are earnest as she places the chalice in your hands.

"You might need this," Hesperie says softly. "Without nectar or ambrosia, gods can lose their immortality and eternal youth. You know this better than anyone."

The Hesperides embrace you one last time. "Good luck, Hebe!" they all say in unison. "We will be here, supporting you in any way we can."

>l
Garden of Hesperides
The Garden of the Hesperides is a mythical paradise, an otherworldly oasis hidden in the middle of the Mediterranean, where the air is perpetually filled with the sweet fragrance of blooming flowers and the gentle hum of bees.

In the heart of the garden stands the sacred tree of the Hesperides, its branches heavy with golden apples that gleam like captured sunlight. The apples, used to make nectar, hang among rich green leaves, guarded by the the Hesperides, the nymphs of the evening and daughters of the night. The nymphs are Aigle, Arethousa, Erytheia and Hesperie.

The story goes that Gaia gifted Hera with branches of golden apples as a wedding present, and Hera, deeply admiring them, begged Gaia to plant them in her garden.

From here you can sail to: 
→ Piraeus
→ Sounio
→ Aulis
→ Paphos

>l
Garden of Hesperides
The Garden of the Hesperides is a mythical paradise, an otherworldly oasis hidden in the middle of the Mediterranean, where the air is perpetually filled with the sweet fragrance of blooming flowers and the gentle hum of bees.

In the heart of the garden stands the sacred tree of the Hesperides, its branches heavy with golden apples that gleam like captured sunlight. The apples, used to make nectar, hang among rich green leaves, guarded by the the Hesperides, the nymphs of the evening and daughters of the night. The nymphs are Aigle, Arethousa, Erytheia and Hesperie.

The story goes that Gaia gifted Hera with branches of golden apples as a wedding present, and Hera, deeply admiring them, begged Gaia to plant them in her garden.

From here you can sail to: 
→ Piraeus
→ Sounio
→ Aulis
→ Paphos

>x Aigle
Aigle radiates with a golden glow, her hair like cascading sunlight, and her eyes shimmering like the first light of dawn. She is the embodiment of brightness and warmth, her presence illuminating the garden with a serene, golden aura.

>i
You are carrying:
  Eternal Chalice of Nectar
  Heracles' Club

>x chalice
The Eternal Chalice of Nectar is a legendary goblet crafted by Hephaestus from shimmering gold, embellished with intricate engravings of vines and blossoms. The chalice can provide an infinite supply of nectar at any moment.

>x the club
You see nothing special about Heracles' Club.

* * *

>give obol to charon
You give Obol to Charon.

The ferryman accepts the token and signals you to jump into the boat. With slow and certain movements, he leads the boat down the dangerous stream, into the opening of a natural cave. You arrive at the Underworld.

>[enter]
Elysian Fields
You can see a Charon's boat here.

I beg your pardon?

>d
Asphodel Meadows
You can see a broken bridge and a plaque here.

>enter bridge
The bridge is hollow and it doesn't seem to lead anywhere. 
Heracles points out the plaque on top of the bridge. "Take a look at this."

"Only the ones who give up all hope of returning shall pass."

Heracles becomes serious. "This means to pass we need to give up our immortality and become mortal." His face softens. "My dearest Hebe... we will do this together. Are you ready?"

>yes
Heracles holds your hands. "Let's go my dearest. It'll be fine." 

 You descend into the abyss.

Darkness
It is pitch dark, and you can't see a thing.

>yes
That was a rhetorical question.

>yes
That was a rhetorical question.

>no
That was a rhetorical question.

>uffa
That's not a verb I recognise.

* * *

>[enter]
Elysian Fields
You can see a Charon's boat here.

>x river
You can't see any such thing.

>x acheron
You can't see any such thing.

>actions
Actions listing on.

>x acheron river
You can't see any such thing.

>showme
Elysial Fields - room
    Charon's boat - open door
    yourself - woman

* * *

>give the club to heracles
(first taking the Heracles' Club)
You picked up the Club of Heracles.

He smiles to you. "Thank you my dearest."

>[enter]
Suddenly, an eerie silence fell over the festive night. The singing and dancing ceased, as if an unseen hand had stilled them. For a brief moment, you felt the coldness of the mountain air, a stark contrast to the pleasant breeze that had enveloped you moments before. A sense of foreboding fills you as you become aware that all eyes are turned behind you. You lock eyes with Heracles, both of you sharing a look of worry. With a growing sense of dread, you turned to see what had drawn everyone's attention.

"Oh dear, please, do not let my presence taint your insignificant gathering. Carry on as you were."

The voice was unmistakable, deep and resonant, carrying an ancient power that sent shivers down your spine. It was Kronos. So much time has passed since our triumph in the War of Titans- the Titanomachy. How did he manage to escape Tartarus?

The sight of the Titan, towering and menacing, shrouded in shadows, struck fear into the hearts of all present. You start to feel the ichor in your divine veins turn cold, as if time itself had frozen. The gods, normally so mighty and formidable, stand paralyzed in shock. Nothing moves. In a heartbeat, you break free from the daze and come to your senses. Your next actions have never been more certain. It's now or never.

You grab Heracle's club out of his hands and leap towards Kronos. Then you feel yourself slipping into unconciousness.

* * *

>[enter]
Garden of Hesperides

From here you can sail to: 
→ Piraeus
→ Sounio
→ Aulis
→ Paphos

You can see Eternal Chalice of Nectar, Aigle, Arethousa, Erytheia and Hesperie here.

>sail to aulis
You sail to the Port of Aulis.

Port of Aulis
To the west you can see the city of Aulis. 

From here you can sail to: 
→ Sounio
→ Garden of Hesperides

>w
Agora of Aulis

>go to temple
You can't see any such thing.

>go in temple
You went into the temple of the aulidean artemis
Temple of the Aulidean Artemis
You step into the sacred temple of Aulidean Artemis. The temple is empty and abandoned by the priestesses, following Kronos' seizure of power, as expected, unfortunately.

As you pass through the pronaos, your eyes are drawn to the sunlight cascading down from the open ceiling, illuminating an imposing sundial made of pearly white marble that stands at the center of the chamber. The sun's rays cross paths with the dial's gnomon, casting a shadow that marks the hour.

Entering the naos, the most divine part of the temple, you find yourself in the presence of the graceful golden statue of Artemis. Your sister stands tall and proud, her form aglow with a divine radiance that speaks of her unyielding strength and purity. In her left hand, she holds the antlers of a noble deer, symbolizing her dominion over the wild, while her right hand grips her bow, ever ready to protect those who dwell under her watchful eye. A quiver, filled with finely crafted arrows, rests upon her back, the tools of the huntress who lets no prey escape.

Directly in front of her statue is the altar of Artemis, a place where mortals would lay their offerings not long ago, hoping to earn her favor.

>i
You are carrying:
  the Heracles' Club

* * *

>go d
You can't go that way.

>go s
Temple of Poseidon
Description of temple of poseidon.

You can see a sea here.

>go u
Sounio Beach
Description of Sounio beach. You see some nereides fighting.

You can see a sea, some nereides, Aktaia, Erato, Ploto and an angry nereida here.

* * *

>go in boat
You should pay the ferryman first. One obol is the standard price.

>enter boat
You should pay the ferryman first. One obol is the standard price.

>give 1 obol to charon
You give Obol to Charon.

The ferryman accepts the token and signals you to jump into the boat. With slow and certain movements, he leads the boat down the dangerous stream, into the opening of a natural cave. You arrive at the Underworld.

>[enter]
Elysian Fields
You can see a Charon's boat here.

>l
Elysian Fields
You can see Charon and a Charon's boat here.

>enter boat
(first opening the Charon's boat)
It isn't something you can open.

The ferryman see you jump into the boat and understands. With slow and certain movements, he leads the boat up the dangerous stream, out of the opening of the natural cave. You are again in the world of the living. He gives you back the obol.

* * *

>go in charon's boat
(first opening the Charon's boat)
It isn't something you can open.

The ferryman see you jump into the boat and understands. With slow and certain movements, he leads the boat up the dangerous stream, out of the opening of the natural cave. You are again in the world of the living. He gives you back the obol.

* * *

>go in lake
You can't. All you can see is dirty water.

>take red flower
You picked up a red flower.

>go in lake
You swim through the waters.

You can't go that way.

>d
You look at the lake. Maybe you can go down through there.

You swim through the waters.

You can't go that way.

>x lake
Poseidon's Power flows through your vains. You can clearly see an underwather path. You wonder if it actually leads you where you should be.

>go lake
You can't go that way.

>d
You look at the lake. Maybe you can go down through there.

You swim through the waters.

You can't go that way.

>open lake
You swim through the waters.

You can't go that way.

* * *

>go in lake
You swim through the waters.

You can't go that way.

>l
Secret Garden
You are in the Secret Garden. You can see red, purple, yellow and white flowers planted in some flowerbeds. In your right you can see some golden amphorae. In the middle of the garden you see an enormous tree with a cavity in the middle. You see lake with shells in the shore. A heavy looking gate that seems to lead to the next room is on the eastern side of the garden, its view mostly obstructed by vines and flowers. In the garden you see a statue of a beautiful man.

>x lake
Poseidon's Power flows through your vains. You can clearly see an underwather path. You wonder if it actually leads you where you should be.

>look lake
Poseidon's Power flows through your vains. You can clearly see an underwather path. You wonder if it actually leads you where you should be.

>is lake open?
That's not a verb I recognise.

>check lake open
I only understood you as far as wanting to check the lake.

>check lake
Poseidon's Power flows through your vains. You can clearly see an underwather path. You wonder if it actually leads you where you should be.

>show me lake
(first taking the lake)
That's fixed in place.

>showme lake
lake - open door
location: in the Secret Garden
unlit, inedible, fixed in place, handled; open, unopenable, unlocked; singular-named, improper-named
description: none
initial appearance: none
leading-through destination: <routine 215723>
printed name: "lake"
printed plural name: "doors"
indefinite article: none
list grouping key: none

>go in lake
You swim through the waters.

You can't go that way.

>d
You can't go that way.

>down
You can't go that way.

>i
You are carrying:
  a red flower
  an aria

>showme lake
lake - open door
location: in the Secret Garden
unlit, inedible, fixed in place, handled; open, unopenable, unlocked; singular-named, improper-named
description: none
initial appearance: none
leading-through destination: <routine 215723>
printed name: "lake"
printed plural name: "doors"
indefinite article: none
list grouping key: none

* * *

>go in lake
You can't. All you can see is dirty water.

>x lake
You see nothing special about the lake.

>enter lake
Secret Garden
You are in the Secret Garden

You see a lake.

A heavy looking gate that seems to lead to the next room is on the eastern side of the garden, its view obstructed by vines and flowers.

You find yourself before a flowerbed with intense red flowers...

a flowerbed with beautiful purple flowers...

a flowerbed with vibrant yellow flowers...

and a flowerbed with pretty white flowers.

In the garden you see a statue of a beautiful man.

You can also see a container B (empty), a container C (empty) and a container D (empty) here.

>open lake
You swim through the waters.

* * *

>go in secret garden
You can't see any such thing.

* * *

>go north
You can't go that way.

>go north
Throne Room
Home to the King of Amathus, Pygmalion.

You can see Pygmalion and Galatea here.

>go down
Secret Garden
Underground Magic Garden

>go north
Divine Cell 4
You see the gods sleeping

You can see Aphrodite and Hephaestus here.

* * *

>go north
You can't go that way.

>n
You can't go that way.

>d
You can't go that way.

>e
You can't go that way.

>w
Agora of Paphos
The main square of Paphos.

>w
Throne Room
Home to the King of Paphos, Pygmalion.

You can see Cinyras here.

>d
Secret Garden
You see many flowers

Red Flowers

You can also see some Amaranths, a statue and a sign here.

>examine statue
The statue depicts a beautiful man. He's holding a basket. It's empty.

* * *

>examine basket
The basket is empty.

>pick up flower
You can't see any such thing.

>pick up red flower
Taken.

>i
You are carrying:
  Adonis

>put adonis in basket
You put Adonis into the basket.

>examine basket
In the basket is Adonis.

>examine statue
The statue depicts a beautiful man. He's holding a basket. It's empty.

>examine sign
The sign is made of marble. The inscription on it reads: Painful memories of our love surround this place.

* * *

>go out
Acropolis

>exit
i exit.

But you aren't in anything at the moment.

>go in prytaneion
You went into the prytaneion
Prytaneion
TODO simple description

You can see a first torch, a second torch, a third torch, a fourth torch, a fifth torch, a sixth torch, a seventh torch, an eighth torch, a ninth torch, a tenth torch, an eleventh torch, a twelfth torch, a thirteenth torch, a fourteenth torch, a fifteenth torch, a sixteenth torch, an empty scroll, a wax tablet, a text scroll and a parchment here.

>exit
i exit.

Acropolis

* * *

>go s
The temple looks like it's too deep. You can't go there with no help.

>enter sea
The nereides agree to take you to the sunken Temple .

Temple of Poseidon
Description of temple of poseidon.

>u
Sounio Beach
Description of Sounio beach. You see some nereides fighting.

You can see some nereides, Aktaia, Erato, Ploto and an angry nereida here.

* * *

>go to auli
You can't see any such thing.

>travel to aulis
You travel to the Gates of Aulis.

Gates of Aulis
From here you can travel to: 
→ Thebes
→ Athens
→  Delphi
→ Ephyra
→ Mount Olympus

>n
Agora of Aulis

>go in temole
You can't see any such thing.

>go in temple
You went into the temple of the aulidean artemis
Temple of the Aulidean Artemis
Inside the Temple of the Aulidean Artemis you can see a sundial, the statue of Artemis and her sacrificial altar.

>go out
Agora of Aulis

>go to temle
You can't see any such thing.

>go to temple
You can't see any such thing.

* * *

>go to olympus
You can't see any such thing.

I beg your pardon?

>go to mount olympus
You can't see any such thing.

>go to the foothills of mount olympus
You can't see any such thing.

>travel to olympus
You travel to the Foothills of Mount Olympus.

Foothills of Mount Olympus
From here you can travel to: 
→ Thebes
→ Aulis
→ Athens
→ Ephyra
→ Delphi

>go to athens
You can't see any such thing.

* * *

>go to olympus
You can't see any such thing.

>showme location
There seems to be no such object anywhere in the model world.

>showme
Northen Gates of Athens - city
    yourself - woman

>go s
Agora of Athens

* * *

>go to temple
The temple looks like it's too deep. You can't go there with no help.

>enter sea
The nereides agree to take you to the sunken Temple .

Temple of Poseidon
Description of temple of poseidon.

* * *

>go to the gates of aulis
You can't see any such thing.

* * *

>go to thebes
You can't see any such thing.

>go to Thebes
You can't see any such thing.

>go to stables of thebes
You can't see any such thing.

* * *

>go to thebes
You can't see any such thing.

>go to stables of thebes
You can't see any such thing.

>go to north
You can't see any such thing.

>go north
Stables of Thebes

* * *

>go to thebes
You can't see any such thing.

>nw
Stables of Thebes

>se
Northen Stables of Athens

>go to Thebes
You can't see any such thing.

>go to Stables of Thebes
You can't see any such thing.

>showme
Northen Stables of Athens - room
    Athens-Thebes road - open door
    yourself - woman
    Athens-Aulis road - open door

* * *

>go to thebes
You can't see any such thing.

>travel to thebes
You travel to the Gates of Thebes.

Gates of Thebes
From here you can travel to: 
→ Athens
→ Aulis
→ Delphi
→ Ephyra
→ Mount Olympus

>s
You can't go that way.

>n
Agora of Thebes

>go in kadmea
You went into the kadmea
Kadmea
on the walls you can see the story of Kadmos, who slayed the Dragon of Ismenus and burried his teeth for the Spartoi to sprink from the ground. In front of you is a stone dragon statue, and a big chess board with some chess pieces already on top. You can see a sacrificial plate on top of the altar. The dvgate has a sign on it.

You can see a dvgate, a rock, a walls, dragon statue, a Kadmea altar (on which is a sacrificial plate (empty)), a pan1, a pan2, a pan3, a pan4, a pan5, a pan6 and a scale here.

* * *

>help
Basic Commands

1. Movement Commands:

   • Go [direction]: Move to another room. Example: "go north", "go in" or "enter", "out".
   • Directions include: north, south, east, west, northeast, northwest, southeast, southwest, up, and down.
   • You can also use the shortcuts n, s, e, w, ne, nw, se, sw, u and d.

2. Interaction Commands:

   • Look: Examine your surroundings. Example: "look", "look around", "l".
   • Examine [object]: Inspect an item in detail. Example: "examine book", "x book".
   • Take [object]: Pick up an item. Example: "take key".
   • Drop [object]: Put down an item. Example: "drop book".
   • Put [object] on/in [object]: Put an item on top or inside another item. Example: "put flower in pot".
   • Open/Close [object]: Open or close something. Example: "open door", "close box".
   • Give [object] to [person]: Give an item to someone. Example: "give book to librarian".

3. Conversation Commands:

   • Talk to [person]: Initiate conversation. Example: "talk to librarian".
   • Ask [person] about [topic]: Ask someone about something specific. Example: "ask librarian about book".
   • Tell [person] about [topic]: Tell someone about a topic. Example: "tell librarian about secret".

4. Miscellaneous Commands:

   • Inventory: See what you're carrying. Example: "inventory", "i".
   • Wait: Pass time. Example: "wait".
   • Save/Restore/Quit: Manage your game. Example: "save", "restore", "quit".

5. Game-Specific Commands:

   • Sacrifice [something].
   • Investigate: Investigate a room to see the list of interactable things in it.
   • Travel to [any port]: Travel from the gates of a city to another's.
   • Sail to [any gates/any city]: Sail from the port of a city to another's.
   • Rotate [object] clockwise/anticlockwise: Rotate a rotatable object.
   • Give nectar to [person]: Make a person immortal or heal an immortal person.

You can also combine commands with objects and people, such as "take book and give it to librarian".

>save
Save failed.

* * *

>i
You are carrying nothing.

The day passes.

At twelve o'clock you hear the click of a latch releasing and a moon hatch opening coming from the dial.

>e
You can't go that way.

>s
You can't go that way.

>x club
You see nothing special about the Heracles' Club.

>i
You are carrying nothing.

>i
You are carrying nothing.

>s
You can't go that way.

>e
You can't go that way.

>n
You can't go that way.

>i
You are carrying nothing.

Hercules asks for his club.

>give club to heracles
(first taking the Heracles' Club)
You picked up a Heracles' Club.

He smiles to you. "Thank you my dearest."

You give the Heracles' Club to the God Heracles.

* * *

>[enter]
Garden of Hesperides
1-2 months timeskip. the nymphs tended to your wounds and restored you with nectar and ambrosia. They tell you what happened with the gods and send you towards the oracle of delphi.

From here you can sail to: 
→ Piraeus
→ Sounio
→ Aulis
→ Paphos

You can see Aigle, Arethousa, Erytheia and Hesperie here.

>sail to aulis
You sail to the Port of Aulis.

Port of Aulis
From here you can sail to: 
→ Sounio
→ Garden of Hesperides

* * *

>s
Gates of Aulis
From here you can travel to: 
→ Thebes
→ Athens
→  Delphi
→ Ephyra
→ Mount Olympus

>n
Agora of Aulis

>w
You can't go that way.

>e
Port of Aulis
From here you can sail to: 
→ Sounio
→ Garden of Hesperides

>w
Agora of Aulis

>sw
You can't go that way.

>nw
You can't go that way.

>s
Gates of Aulis
From here you can travel to: 
→ Thebes
→ Athens
→  Delphi
→ Ephyra
→ Mount Olympus

>mapindex
That's not a verb I recognise.

>actions
Actions listing on.

>s
[going south]
You can't go that way.
[going south - failed the can't go that way rule]

>n
[going north]

Agora of Aulis
[going north - succeeded]

>e
[going east]

Port of Aulis
From here you can sail to: 
→ Sounio
→ Garden of Hesperides

[going east - succeeded]

>w
[going west]

Agora of Aulis
[going west - succeeded]

>w
[going west]
You can't go that way.
[going west - failed the can't go that way rule]

>d
[going down]
You can't go that way.
[going down - failed the can't go that way rule]

>u
[going up]
You can't go that way.
[going up - failed the can't go that way rule]

>s
[going south]

Gates of Aulis
From here you can travel to: 
→ Thebes
→ Athens
→  Delphi
→ Ephyra
→ Mount Olympus

[going south - succeeded]

>travel to delphi
[traveling Gates of Delphi]
You travel to the Gates of Delphi.

[(1) looking]
Gates of Delphi
From here you can travel to: 
→ Thebes 
→ Athens
→ Aulis
→ Ephyra
→ Mount Olympus

[(1) looking - succeeded]

[traveling Gates of Delphi - succeeded]

>go w
[going west]

Agora of Delphi
[going west - succeeded]

>w
[going west]

Oracle of Delphi
You can see Pytheia here.

[going west - succeeded]

>e
[going east]

Agora of Delphi
[going east - succeeded]

>e
[going east]

Gates of Delphi
From here you can travel to: 
→ Thebes 
→ Athens
→ Aulis
→ Ephyra
→ Mount Olympus

[going east - succeeded]

>travel to ephyra
[traveling Gates of Ephyra]
You travel to the Gates of Ephyra.

[(1) looking]
Gates of Ephyra
From here you can travel to: 
→ Mount Olympus 
→ Athens
→ Thebes
→ Aulis
→ Delphi

[(1) looking - succeeded]

[traveling Gates of Ephyra - succeeded]

>e
[going east]

East of Ephyra
[going east - succeeded]

>go in acheron river
[entering the acheron river]
You went into the acheron river
[(1) looking]
Acheron River
Acheron River.

[(1) looking - succeeded]

[entering the acheron river - succeeded]

>d
[going down]

Elysial Fields
[going down - succeeded]

>d
[going down]

Asphodel Meadows
[going down - succeeded]

>showme
Asphodel Meadows - room
    yourself - woman
        Heracles' Club
    God Heracles - man

>i
[taking inventory]
You are carrying:
  a Heracles' Club

[taking inventory - succeeded]

* * *

>i
You are carrying nothing.

The day passes.

At twelve o'clock you hear the click of a latch releasing and a moon hatch opening coming from the dial.

>give club to heracles
(first taking the Heracles' Club)
You picked up a Heracles' Club.

He smiles to you. "Thank you my dearest."

You give the Heracles' Club to the God Heracles.

>[enter]
Suddenly, an eerie silence fell over the festive night. The singing and dancing ceased, as if an unseen hand had stilled them. For a brief moment, you felt the coldness of the mountain air, a stark contrast to the pleasant breeze that had enveloped you moments before. A sense of foreboding fills you as you become aware that all eyes are turned behind you. You lock eyes with Heracles, both of you sharing a look of worry. With a growing sense of dread, you turned to see what had drawn everyone's attention.

"Oh dear, please, do not let my presence taint your insignificant gathering. Carry on as you were."

The voice was unmistakable, deep and resonant, carrying an ancient power that sent shivers down your spine. It was Kronos. So much time has passed since our triumph in the War of Titans- the Titanomachy. How did he manage to escape Tartarus?

The sight of the Titan, towering and menacing, shrouded in shadows, struck fear into the hearts of all present. You start to feel the ichor in your divine veins turn cold, as if time itself had frozen. The gods, normally so mighty and formidable, stand paralyzed in shock. Nothing moves. In a heartbeat, you break free from the daze and come to your senses. Your next actions have never been more certain. It's now or never.

You grab Heracle's club out of his hands and leap towards Kronos. Then you feel yourself slipping into unconciousness.

* * *

>travel to ephyra
You travel to the Gates of Ephyra.

Gates of Ephyra
From here you can travel to: 
→ Mount Olympus 
→ Athens
→ Thebes
→ Aulis
→ Delphi

>n
North of Ephyra

>enter necromanteion
You went into the necromanteion
Necromanteion
You can see a necromanteion altar and a flower here.

>sacrifice flower
(first taking the flower)
You picked up a flower.

You put the flower on the altar and, with the help of the Priestess, you light it on fire. Persephone acknowledges you.

You gained an obol from the sacrifice.

>i
You are carrying:
  an obol
  a Heracles' Club

>out
North of Ephyra

>s
Gates of Ephyra
From here you can travel to: 
→ Mount Olympus 
→ Athens
→ Thebes
→ Aulis
→ Delphi

>e
East of Ephyra
You can see a Charon's boat and Charon here.

>give an obol to charon
You give 0 obol to Charon.

The ferryman accepts the token and signals you to jump into the boat. With slow and certain movements, he leads the boat down the dangerous stream, into the opening of a natural cave. You arrive at the Underworld.

>a
Elysian Fields
You can see a Charon's boat here.

* * *

>i
You are carrying nothing.

The day passes.

At twelve o'clock you hear the click of a latch releasing and a moon hatch opening coming from the dial.

>give the obol to charon
You give Obol to Charon.

The ferryman accepts the token and signals you to jump into the boat. With slow and certain movements, he leads the boat down the dangerous stream, into the opening of a natural cave. You arrive at the Underworld.

Elysial Fields
You can see a Charon's boat here.

* * *

>i
You are carrying nothing.

The day passes.

At twelve o'clock you hear the click of a latch releasing and a moon hatch opening coming from the dial.

>i
You are carrying nothing.

Hercules asks for his club.

>e
You can't go that way.

Hercules asks for his club.

>showme turn counter
There seems to be no such object anywhere in the model world.

* * *

>i
You are carrying nothing.

The day passes.

At twelve o'clock you hear the click of a latch releasing and a moon hatch opening coming from the dial.

>put aria in sun lock
Hmmm you don't think this would go there.

>wait until 12
It is twelve o'clock now.

At twelve o'clock you hear the sound of the sun pocket opening.

>take sun key
You picked up a sun key.

>put sun key in sun lock
You put the sun key into the sun lock.

* * *

>i
You are carrying nothing.

The day passes.

At twelve o'clock you hear the click of a latch releasing and a moon hatch opening coming from the dial.

>scenes
Scene 'Entire Game' playing (for -539 mins now)
Scene 'Day' playing (for -539 mins now)
(Scene monitoring now switched on. Type "scenes off" to switch it off again.)

>l
Temple of the Aulidean Artemis
Inside the Temple of the Aulidean Artemis you can see a sundial, the statue of Artemis and her sacrificial altar.

>x dial
(the sundial)
The dial is designed with two separate rings encircling its plate, one with sun and one with lunar markings, allowing you to read the time day and night. You also see on the gnomon an inscription engraved and gilded in gold that says: At midday, let Apollo's light cast a shadow, and at midnight, let Artemis' glow guide the way. Only then shall the twins unveil the hidden path.

Judging by the gnomon's shadow and the moon markings, the time is twelve o'clock.

>scenes
Scene 'Entire Game' playing (for -537 mins now)
Scene 'Day' playing (for -537 mins now)
(Scene monitoring now switched on. Type "scenes off" to switch it off again.)

>wait until 4 pm
It is four o'clock now.

>wait until midnight
It is twelve o'clock now.

>wait until 7 pm
It is seven o'clock now.

>scenes
Scene 'Entire Game' playing (for -534 mins now)
Scene 'Day' playing (for -534 mins now)
(Scene monitoring now switched on. Type "scenes off" to switch it off again.)

>wait until 3 am
At ten past twelve you hear the sound of the moon hatch closing and the click of a latch locking coming from the dial.

It is three o'clock now.

>x dial
(the sundial)
The inscription engraved on the gnomon read: At midday, let Apollo's light cast no shadow, and at midnight, let Artemis' glow guide the way. Only then shall the twins unveil the hidden path.

Judging by the gnomon's shadow and the moon markings, the time is three o'clock.

>scenes
Scene 'Entire Game' playing (for -358 mins now)
Scene 'Day' playing (for -358 mins now)
(Scene monitoring now switched on. Type "scenes off" to switch it off again.)

>scenes
Scene 'Entire Game' playing (for -358 mins now)
Scene 'Day' playing (for -358 mins now)
(Scene monitoring now switched on. Type "scenes off" to switch it off again.)

* * *

>i
You are carrying nothing.

The day passes.

At twelve o'clock you hear the click of a latch releasing and a moon hatch opening coming from the dial.

>wait
Time passes.
Would you maybe prefer waiting until a certain time?

>wait
Time passes.
Would you maybe prefer waiting until a certain time?

Olympus Hall Celebration Scene ended

>sleep
You aren't feeling especially drowsy.

>ask heracles about his club
You can't see any such thing.

>l
Mount Olympus Hall
Olympus Hall Destruction Description

You can see a Heracles' Club here.

* * *

>investigate
In the open Prytaneion hall you see the sacred hearth of Hestia, a pine dining table with matching pine chairs and an empty scroll, a wax tablet, a papyrus scroll and a parchment scroll on top of it. Bellow the table and chairs is a red carpet.

There are also 8 torches on either side of the hearth, forming a semicircle around the dining area.

>open trapdoor
You can't see such thing.

>push table
You put all your strength into pushing the table off the carpet- and you manage it!

>move chair
You push the chairs off the carpet.

>move carpet
You pulled the carpet. 

By pulling the carpet out of the way you revealed a trapdoor.

>move table
You pushed the table on on the trapdoor.

>open trapdoor
You can't open the trapdoor when stuff is on top of it!

>test  fire
(Testing.)

>[1] light second torch
You picked up the portable torch.

You lighted the second torch using the portable torch.

>[2] light third torch
You lighted the third torch using the portable torch.

>[3] light sixth torch
You lighted the sixth torch using the portable torch.

>[4] light seventh torch
You lighted the seventh torch using the portable torch.

>[5] light eighth torch
You lighted the eighth torch using the portable torch.

>[6] light tenth torch
You lighted the tenth torch using the portable torch.

>[7] light eleventh torch
You lighted the eleventh torch using the portable torch.

>[8] light thirteenth torch
You lighted the thirteenth torch using the portable torch.

>[9] light fourteent torch
You lighted the fourteenth torch using the portable torch.

>[10] light fifteenth torch
You lighted the fifteenth torch using the portable torch.

>[11] light sixteenth torch
You lighted the sixteenth torch using the portable torch.

You hear the sound of the trapdoor unlocking.

>open trapdoor
You can't open the trapdoor when stuff is on top of it!

>showme chair
chair - thing
location: on the floor in Prytaneion
unlit, inedible, fixed in place, scenery; singular-named, improper-named; pushed
description: "The chairs are a matching set with the table, all crafted of pine."
initial appearance: none
smell: neutral
printed name: "chair"
printed plural name: none
indefinite article: none
list grouping key: none

>show me table
(first taking the pine table)
The table is too heavy for you to lift!

>showme table
(the pine table)
pine table - supporter
    empty scroll
    wax tablet
    papyrus scroll
    parchment scroll
location: on the carpet in Prytaneion
unlit, inedible, fixed in place, scenery; transparent; singular-named, improper-named; unpushed
description: "A large, pine table, likely reserved for the official dinners and gatherings of the prytaneis."
initial appearance: none
smell: neutral
carrying capacity: 100
printed name: "pine table"
printed plural name: "supporters"
indefinite article: none
list grouping key: none

>showme trapdoor
trapdoor - closed door
location: in Prytaneion
unlit, inedible, fixed in place, scenery; closed, openable, lockable, unlocked; singular-named, improper-named; interactable
description: none
initial appearance: none
smell: neutral
leading-through destination: <routine 241972>
printed name: "trapdoor"
printed plural name: "doors"
indefinite article: none
list grouping key: none

>open trapdoor
You can't open the trapdoor when stuff is on top of it!

>move chair
You push the chairs on on the trapdoor.

>move carpet
You can't put the carpet under other furniture before moving them first.

>move table
You pushed the table off the carpet.

>move chair
You push the chairs off the carpet.

>open trapdoor
You open the trapdoor.

>push chair
You shouldn't push anything on top of the open trapdoor.

* * *

>l
Prytaneion
You step into the open hall of the Prytaneion, the administrative heart of Athens. In the center of the room you see the sacred hearth dedicated to Hestia, its warm glow illuminating the room. The flames burn steadily, their smoke rising in delicate spirals before disappearing through a square opening in the roof above. Beside the hearth lies a single hand torch, accompanied by a fire snuffer.

Just beyond the hearth, there is a small dining area. A large table made of pine, surrounded by several chairs, stands atop an elegant carpet, likely reserved for official dinners and gatherings. Scattered across the table are an empty scroll, a wax tablet, a papyrus scroll and a parchment scroll, remnants of a recent meeting, perhaps.

Eight torches on either side of the hearth are placed on the ground, forming a semicircle around the dining area. The torches are all put out, from the first-the far left one-to the sixteenth-the far right one.

The rest of the building remains inaccessible, since the doors lead to the private quarters of the prytaneis and thus are firmly locked, leaving the main hall as the only accessible space.

>d
You can't go that way.

>u
You can't go that way.

>e
You can't go that way.

* * *

>w
You can't go that way.

>s
The nereides agree to take you to the sunken Temple.

Poseidon's Temple
You see a coloumn with 4 rotatable discs. The discs have 5 faces, 4 of them with a picture and one empty. The pictures are the same on each disc and they are in order: Budding olives and fresh green leaves, Green olives growing in size, with fuller leaves, Ripe, darkening olives ready for harvest, some fallen to the ground and Bare branches with a few remaining leaves, the tree in a state of dormancy. The faces towards the altar are all empty.

Altar.

Column that faces the altar.

On the column are top ring, second ring, third ring and bottom ring.

You can also see a temple door here.

>d
(first opening the temple door)
It isn't something you can open.

>n
You can't go that way.

>u
Sounio Beach
Description of Sounio beach. You see some nereides fighting. Poseidon's temple is in the sea.

You can see some nereides, Aktaia, Erato, Ploto and an angry nereida here.

* * *

>examine red flowerbed
You can see some red flowers in this flowerbed

In the red flowerbed are ten red flowers.

>take flowers
red flower: You picked up a red flower.
red flower: You picked up a red flower.
red flower: You picked up a red flower.
red flower: You picked up a red flower.
red flower: You picked up a red flower.
red flower: You picked up a red flower.
red flower: You picked up a red flower.
red flower: You picked up a red flower.
red flower: You picked up a red flower.
red flower: That was the last red flower. There are no more in this garden.
purple flower: You picked up a purple flower.
purple flower: You picked up a purple flower.
purple flower: You picked up a purple flower.
purple flower: You picked up a purple flower.
purple flower: You picked up a purple flower.
purple flower: You picked up a purple flower.
purple flower: You picked up a purple flower.
purple flower: You picked up a purple flower.
purple flower: You picked up a purple flower.
purple flower: That was the last purple flower. There are no more in this garden.
yellow flower: You picked up a yellow flower.
yellow flower: You picked up a yellow flower.
yellow flower: You picked up a yellow flower.
yellow flower: You picked up a yellow flower.
yellow flower: You picked up a yellow flower.
yellow flower: You picked up a yellow flower.
yellow flower: You picked up a yellow flower.
yellow flower: You picked up a yellow flower.
yellow flower: You picked up a yellow flower.
yellow flower: That was the last yellow flower. There are no more in this garden.
white flower: You picked up a white flower.
white flower: You picked up a white flower.
white flower: You picked up a white flower.
white flower: You picked up a white flower.
white flower: You picked up a white flower.
white flower: You picked up a white flower.
white flower: You picked up a white flower.
white flower: You picked up a white flower.
white flower: You picked up a white flower.
white flower: That was the last white flower. There are no more in this garden.

>l
Secret Garden
You are in the Secret Garden

You find yourself before a beautiful flowerbed with vibrant red flowers.

You find yourself before a beautiful flowerbed with vibrant purple flowers.

You find yourself before a beautiful flowerbed with vibrant yellow flowers.

You find yourself before a beautiful flowerbed with vibrant white flowers.

You can also see a puzzle gate, a statue, a container B (empty), a container C (empty) and a container D (empty) here.

>x puzzle gate
The puzzle gate is locked.

>take puzzle gate
That's fixed in place.

>take statue
That's fixed in place.

>unlock puzzle gate
What do you want to unlock the puzzle gate with?

>air
You can't see any such thing.

>nothing
That's not a verb I recognise.

>my hands
That's not a verb I recognise.

>x statue
The statue depicts a beautiful man. There is a sign on the statue's base. His hands look like they're holding something but there's nothing there. You notice the Greek number A on the statue.

>take nothing
You can't see any such thing.

>take greek number A
You can't see any such thing.

>x greek number A
You can't see any such thing.

>x sign
The sign is made of marble. The inscription on it reads: Painful memories of our love surround this place. (A > red, B > purple, C> yellow, D>white)

>take A
You can't see any such thing.

>l
Secret Garden
You are in the Secret Garden

You find yourself before a beautiful flowerbed with vibrant red flowers.

You find yourself before a beautiful flowerbed with vibrant purple flowers.

You find yourself before a beautiful flowerbed with vibrant yellow flowers.

You find yourself before a beautiful flowerbed with vibrant white flowers.

You can also see a puzzle gate, a statue, a container B (empty), a container C (empty) and a container D (empty) here.

>x container A
You can't see any such thing.

>x container B
The container B is empty.

>take container B
That's fixed in place.

>x statue
The statue depicts a beautiful man. There is a sign on the statue's base. His hands look like they're holding something but there's nothing there. You notice the Greek number A on the statue.

* * *

>x hands
The hands is empty.

>take hands
That seems to be a part of the statue.

>put purple flowers in container b
purple flower: Done.
purple flower: Done.
purple flower: Done.
purple flower: Done.
purple flower: Done.
purple flower: Done.
purple flower: Done.
purple flower: Done.
purple flower: Done.
purple flower: Done.

>put yellow flowers in container c
yellow flower: Done.
yellow flower: Done.
yellow flower: Done.
yellow flower: Done.
yellow flower: Done.
yellow flower: Done.
yellow flower: Done.
yellow flower: Done.
yellow flower: Done.
yellow flower: Done.

>i
You are carrying:
  ten white flowers
  ten red flowers

>put white flowers in container D
white flower: Done.
white flower: Done.
white flower: Done.
white flower: Done.
white flower: Done.
white flower: Done.
white flower: Done.
white flower: Done.
white flower: Done.
white flower: Done.

>unlock puzzle door
I didn't understand that sentence.

>x
(the red flower)
This is an Adonis Flower.

>l
Secret Garden
You are in the Secret Garden

You find yourself before a beautiful flowerbed with vibrant red flowers.

You find yourself before a beautiful flowerbed with vibrant purple flowers.

You find yourself before a beautiful flowerbed with vibrant yellow flowers.

You find yourself before a beautiful flowerbed with vibrant white flowers.

You can also see a puzzle gate, a statue, a container B (in which are ten purple flowers), a container C (in which are ten yellow flowers) and a container D (in which are ten white flowers) here.

>unlock puzzle gate
(with the red flower)
That doesn't seem to fit the lock.

>x puzzle gate
The puzzle gate is locked.

>remove 9 flowers from container b
purple flower: That was the last purple flower. There are no more in this garden.
purple flower: That was the last purple flower. There are no more in this garden.
purple flower: That was the last purple flower. There are no more in this garden.
purple flower: That was the last purple flower. There are no more in this garden.
purple flower: That was the last purple flower. There are no more in this garden.
purple flower: That was the last purple flower. There are no more in this garden.
purple flower: That was the last purple flower. There are no more in this garden.
purple flower: That was the last purple flower. There are no more in this garden.
purple flower: That was the last purple flower. There are no more in this garden.

>remove 9 flwoers from container c
I didn't understand that sentence.

>emove 9 flowers from container d
That's not a verb I recognise.

>remove 9 flowers from container d
white flower: That was the last white flower. There are no more in this garden.
white flower: That was the last white flower. There are no more in this garden.
white flower: That was the last white flower. There are no more in this garden.
white flower: That was the last white flower. There are no more in this garden.
white flower: That was the last white flower. There are no more in this garden.
white flower: That was the last white flower. There are no more in this garden.
white flower: That was the last white flower. There are no more in this garden.
white flower: That was the last white flower. There are no more in this garden.
white flower: That was the last white flower. There are no more in this garden.

>unlock puzzle gate
What do you want to unlock the puzzle gate with?

>x puzzle gate
The puzzle gate is locked.

>x containers
Which do you mean, the red flowerbed, the purple flowerbed, the yellow flowerbed, the white flowerbed, the hands, the container B, the container C or the container D?

* * *

>x container b
In the container B is a purple flower.

>x container c
In the container C are ten yellow flowers.

>x container d
In the container D is a white flower.

>remove 9 flowers from container c
yellow flower: That was the last yellow flower. There are no more in this garden.
yellow flower: That was the last yellow flower. There are no more in this garden.
yellow flower: That was the last yellow flower. There are no more in this garden.
yellow flower: That was the last yellow flower. There are no more in this garden.
yellow flower: That was the last yellow flower. There are no more in this garden.
yellow flower: That was the last yellow flower. There are no more in this garden.
yellow flower: That was the last yellow flower. There are no more in this garden.
yellow flower: That was the last yellow flower. There are no more in this garden.
yellow flower: That was the last yellow flower. There are no more in this garden.

>x puzzle gate
The puzzle gate is locked.

>x container b
In the container B is a purple flower.

>x container c
In the container C is a yellow flower.

>x container d
In the container D is a white flower.

>x sign
The sign is made of marble. The inscription on it reads: Painful memories of our love surround this place. (A > red, B > purple, C> yellow, D>white)

I beg your pardon?

>x container A
You can't see any such thing.

>x hands
The hands is empty.

>eat hands
That's plainly inedible.

>touch hands
You feel nothing unexpected.

>put 200000000000 red flowers in hands
Only ten of those are available.

>put 1 red flower in hands
You put the red flower into the hands.

You hear the gate unlocking.

>enter puzzle gate
(first opening the puzzle gate)
It seems to be locked.

You hear the gate unlocking.

>x puzzle gate
The puzzle gate is now unlocked.

You hear the gate unlocking.

>unlock puzzle gate
What do you want to unlock the puzzle gate with?

I beg your pardon?

>open puzzle gate
You open the puzzle gate.

You hear the gate unlocking.

>enter puzzle gate
Divine Cell 4
You see the gods sleeping

You can see a puzzle gate, Aphrodite and Hephaestus here.

You hear the gate unlocking.

>take gods
You can't see any such thing.

>take Aphrodite
I don't suppose Aphrodite would care for that.

You hear the gate unlocking.

>take gate
That's fixed in place.

You hear the gate unlocking.

* * *

>investigate
There isn't much to investigate here.

>help
Basic Commands

1. Movement Commands:

   • Go [direction]: Move to another room. Example: "go north", "go in" or "enter", "out".
   • Directions include: north, south, east, west, northeast, northwest, southeast, southwest, up, and down.
   • You can also use the shortcuts n, s, e, w, ne, nw, se, sw, u and d.

2. Interaction Commands:

   • Look: Examine your surroundings. Example: "look", "look around", "l".
   • Examine [object]: Inspect an item in detail. Example: "examine book", "x book".
   • Take [object]: Pick up an item. Example: "take key".
   • Drop [object]: Put down an item. Example: "drop book".
   • Put [object] on/in [object]: Put an item on top or inside another item. Example: "put flower in pot".
   • Open/Close [object]: Open or close something. Example: "open door", "close box".
   • Give [object] to [person]: Give an item to someone. Example: "give book to librarian".

3. Conversation Commands:

   • Talk to [person]: Initiate conversation. Example: "talk to librarian".
   • Ask [person] about [topic]: Ask someone about something specific. Example: "ask librarian about book".
   • Tell [person] about [topic]: Tell someone about a topic. Example: "tell librarian about secret".

4. Miscellaneous Commands:

   • Inventory: See what you're carrying. Example: "inventory", "i".
   • Wait: Pass time. Example: "wait".
   • Save/Restore/Quit: Manage your game. Example: "save", "restore", "quit".

5. Game-Specific Commands:

   • Sacrifice [something].
   • Investigate: Investigate a room to see the list of interactable things in it.
   • Travel to [any port]: Travel from the gates of a city to another's.
   • Sail to [any gates/any city]: Sail from the port of a city to another's.
   • Rotate [object] clockwise/anticlockwise: Rotate a rotatable object.
   • Give nectar to [person]: Make a person immortal or heal an immortal person.

You can also combine commands with objects and people, such as "take book and give it to librarian".

>l
Prytaneion
You step into the open hall of the Prytaneion, the administrative heart of Athens. In the center of the room you see the sacred hearth dedicated to Hestia, its warm glow illuminating the room. The flames burn steadily, their smoke rising in delicate spirals before disappearing through a square opening in the roof above. Beside the hearth lies a single hand torch, accompanied by a fire snuffer.

Just beyond the hearth, there is a small dining area. A large table made of pine, surrounded by several chairs, stands atop an elegant carpet, likely reserved for official dinners and gatherings. Scattered across the table are an empty scroll, a wax tablet, a papyrus scroll and a parchment scroll, remnants of a recent meeting, perhaps.

Eight torches on either side of the hearth are placed on the ground, forming a semicircle around the dining area. The torches are all put out, from the first-the far left one-to the sixteenth-the far right one.

The rest of the building remains inaccessible, since the doors lead to the private quarters of the prytaneis and thus are firmly locked, leaving the main hall as the only accessible space.

>test
>--> The following tests are available:
'test getweights'
'test dragongate'
'test pos'
'test art'
'test solutionsg'
'test sg2'
'test fire'

>test fire
(Testing.)

>[1] light second torch
You picked up the portable torch.

You lighted the second torch using the portable torch.

>[2] light third torch
You lighted the third torch using the portable torch.

>[3] light sixth torch
You lighted the sixth torch using the portable torch.

>[4] light seventh torch
You lighted the seventh torch using the portable torch.

>[5] light eighth torch
You lighted the eighth torch using the portable torch.

>[6] light tenth torch
You lighted the tenth torch using the portable torch.

>[7] light eleventh torch
You lighted the eleventh torch using the portable torch.

>[8] light thirteenth torch
You lighted the thirteenth torch using the portable torch.

>[9] light fourteent torch
You lighted the fourteenth torch using the portable torch.

>[10] light fifteenth torch
You lighted the fifteenth torch using the portable torch.

>[11] light sixteenth torch
You lighted the sixteenth torch using the portable torch.

You hear the sound of something unlocking.

>l
Prytaneion
You step into the open hall of the Prytaneion, the administrative heart of Athens. In the center of the room you see the sacred hearth dedicated to Hestia, its warm glow illuminating the room. The flames burn steadily, their smoke rising in delicate spirals before disappearing through a square opening in the roof above. Beside the hearth lies a single hand torch, accompanied by a fire snuffer.

Just beyond the hearth, there is a small dining area. A large table made of pine, surrounded by several chairs, stands atop an elegant carpet, likely reserved for official dinners and gatherings. Scattered across the table are an empty scroll, a wax tablet, a papyrus scroll and a parchment scroll, remnants of a recent meeting, perhaps.

Eight torches on either side of the hearth are placed on the ground, forming a semicircle around the dining area. The torches are all put out, from the first-the far left one-to the sixteenth-the far right one.

The rest of the building remains inaccessible, since the doors lead to the private quarters of the prytaneis and thus are firmly locked, leaving the main hall as the only accessible space.

>l
Prytaneion
You step into the open hall of the Prytaneion, the administrative heart of Athens. In the center of the room you see the sacred hearth dedicated to Hestia, its warm glow illuminating the room. The flames burn steadily, their smoke rising in delicate spirals before disappearing through a square opening in the roof above. Beside the hearth lies a single hand torch, accompanied by a fire snuffer.

Just beyond the hearth, there is a small dining area. A large table made of pine, surrounded by several chairs, stands atop an elegant carpet, likely reserved for official dinners and gatherings. Scattered across the table are an empty scroll, a wax tablet, a papyrus scroll and a parchment scroll, remnants of a recent meeting, perhaps.

Eight torches on either side of the hearth are placed on the ground, forming a semicircle around the dining area. The torches are all put out, from the first-the far left one-to the sixteenth-the far right one.

The rest of the building remains inaccessible, since the doors lead to the private quarters of the prytaneis and thus are firmly locked, leaving the main hall as the only accessible space.

>l
Secret Garden
You find yourself in an enchanted underground garden, where magic seems to pulse from every corner. The air is thick with the intoxicating scent of flowers, each blossom radiating a soft, ethereal glow. Though deep beneath the earth, the space is bathed in a gentle, divine light radiating from the plants themselves, complemented by the soft flicker of the candles lining the paths, their wax bodies somehow untouched by time or flame. Despite the absence of any other life, the garden feels alive, giving the impression it exists in a suspended moment between the past and present.

As one steps through the entrance, their eyes would be immediately drawn to a statue of an incomprehensibly beautiful man, poised on a marble base. His right hand is raised, his gaze fixed intently on it, as if beholding some unseen object. Behind the statue lies a serene natural lake, with delicate pink and white lilies gently laying on its surface. On the other side of the water, a majestic olive tree stands, ancient and hollowed by the passage of centuries, its gnarled bark a testament to its age. Some round flower beds bursting with vibrant red, purple, and orange flowers are encircling the lake and the tree.

On the eastern side of the room, separated by a couple of steps decorated with flowers and candles, there is a secluded perfume-making area. Here, counters are crowded with the tools and equipment necessary for crafting fragrant elixirs, while ceramic amphorae are stored beneath, likely to store finished scents. The area leads to a gate covered in vines and flowers, making passage through it impossible.

>i
You are carrying nothing.

>investigate
In the Secret Garden you see a statue of a man, a lake, an olive tree and some flowerbeds with red, purple and orange flowers. In the perfume-making area there are some ceramic amphorae and a gate.

>x lake
It's a beautiful lake full of pink and white water lilies sitting on its surface.

>go in lake
Maybe it's best not to do that. The lake looks like it might be pretty deep and, besides, you wouldn't want to disturb the water lilies.

>go d
You can't go that way.

>do u
That's not a verb I recognise.

>go u
Throne Room
Home to the King of Paphos, Cinyras. Down is the Secret Garden.

You can see Cinyras here.

>d
Secret Garden
You find yourself in an enchanted underground garden, where magic seems to pulse from every corner. The air is thick with the intoxicating scent of flowers, each blossom radiating a soft, ethereal glow. Though deep beneath the earth, the space is bathed in a gentle, divine light radiating from the plants themselves, complemented by the soft flicker of the candles lining the paths, their wax bodies somehow untouched by time or flame. Despite the absence of any other life, the garden feels alive, giving the impression it exists in a suspended moment between the past and present.

As one steps through the entrance, their eyes would be immediately drawn to a statue of an incomprehensibly beautiful man, poised on a marble base. His right hand is raised, his gaze fixed intently on it, as if beholding some unseen object. Behind the statue lies a serene natural lake, with delicate pink and white lilies gently laying on its surface. On the other side of the water, a majestic olive tree stands, ancient and hollowed by the passage of centuries, its gnarled bark a testament to its age. Some round flower beds bursting with vibrant red, purple, and orange flowers are encircling the lake and the tree.

On the eastern side of the room, separated by a couple of steps decorated with flowers and candles, there is a secluded perfume-making area. Here, counters are crowded with the tools and equipment necessary for crafting fragrant elixirs, while ceramic amphorae are stored beneath, likely to store finished scents. The area leads to a gate covered in vines and flowers, making passage through it impossible.

>l
Secret Garden
You find yourself in an enchanted underground garden, where magic seems to pulse from every corner. The air is thick with the intoxicating scent of flowers, each blossom radiating a soft, ethereal glow. Though deep beneath the earth, the space is bathed in a gentle, divine light radiating from the plants themselves, complemented by the soft flicker of the candles lining the paths, their wax bodies somehow untouched by time or flame. Despite the absence of any other life, the garden feels alive, giving the impression it exists in a suspended moment between the past and present.

As one steps through the entrance, their eyes would be immediately drawn to a statue of an incomprehensibly beautiful man, poised on a marble base. His right hand is raised, his gaze fixed intently on it, as if beholding some unseen object. Behind the statue lies a serene natural lake, with delicate pink and white lilies gently laying on its surface. On the other side of the water, a majestic olive tree stands, ancient and hollowed by the passage of centuries, its gnarled bark a testament to its age. Some round flower beds bursting with vibrant red, purple, and orange flowers are encircling the lake and the tree.

On the eastern side of the room, separated by a couple of steps decorated with flowers and candles, there is a secluded perfume-making area. Here, counters are crowded with the tools and equipment necessary for crafting fragrant elixirs, while ceramic amphorae are stored beneath, likely to store finished scents. The area leads to a gate covered in vines and flowers, making passage through it impossible.

>investigat
In the Secret Garden you see a statue of a man, a lake, an olive tree and some flowerbeds with red, purple and orange flowers. In the perfume-making area there are some ceramic amphorae and a gate.

>x statue
The statue depicts a man with breathtaking beauty. His figure is carved with exquisite detail, and his chiseled features and graceful form are captured with masterful artistry. There is a longingness in his gaze, which falls on his raised right hand.

His right hand looks like it could be holding something but there's nothing there.
 
You can also see a marble sign on the statue's base.

>take statue
That's fixed in place.

>x sign
The inscription on it reads: 

 May our love root and grow eternally, even though I am but mortal.
 I am afraid I will pass from this world still holding on to the bittersweet memory of you.
 Even in our parting I will find solace in your scent.

>inve
That's not a verb I recognise.

>investi
That's not a verb I recognise.

>investiga
In the Secret Garden you see a statue of a man, a lake, an olive tree and some flowerbeds with red, purple and orange flowers. In the perfume-making area there are some ceramic amphorae and a gate.

>x olive tree
An ancient olive tree with hollowed trunk worn by centuries. The visible part of its roots is thick and robust, making it likely that the roots are extending beneath the entire garden, weaving through the earth like ancient lifelines. A deep cavity runs through its center.

>x flowerbed
Which do you mean, the red flowerbed, the purple flowerbed or the orange flowerbed?

>x orange flowerbed
You can see some orange flowers in this flowerbed.

>x cavity
Inside the cavity are three candles that burn softly.

>x candles
You can't see any such thing.

>x candle
You see nothing special about the candle.

>investiga
In the Secret Garden you see a statue of a man, a lake, an olive tree and some flowerbeds with red, purple and orange flowers. In the perfume-making area there are some ceramic amphorae and a gate.

>x red flowerbed
You can see some red flowers in this flowerbed.

>take red flowerbed
That's fixed in place.

>take olive tree
That's fixed in place.

>take candle
That's fixed in place.

>x amphorae
There are three amphorae placed under the counter. They are ceramic and on them are depicted scenes painted with thin strokes of golden paint, showcasing excelent craftstmanship. The scenes portray the proccess of perfume making.
 You notice that all of them are a bit dusty, but one - the one on the right.

>x right amphora
This amphora depicts a scene of two women picking roses. It is empty.

>smell rose
You can't see any such thing.

>smell red flower
It smells good.

>put red flower in right amphora
(first taking the red flower)
You picked up a red flower.

You put the red flower into the right amphora.

>undust central amphora
That's not a verb I recognise.

>clean central amphora
You can't see any such thing.

>l
Secret Garden
You find yourself in an enchanted underground garden, where magic seems to pulse from every corner. The air is thick with the intoxicating scent of flowers, each blossom radiating a soft, ethereal glow. Though deep beneath the earth, the space is bathed in a gentle, divine light radiating from the plants themselves, complemented by the soft flicker of the candles lining the paths, their wax bodies somehow untouched by time or flame. Despite the absence of any other life, the garden feels alive, giving the impression it exists in a suspended moment between the past and present.

As one steps through the entrance, their eyes would be immediately drawn to a statue of an incomprehensibly beautiful man, poised on a marble base. His right hand is raised, his gaze fixed intently on it, as if beholding some unseen object. Behind the statue lies a serene natural lake, with delicate pink and white lilies gently laying on its surface. On the other side of the water, a majestic olive tree stands, ancient and hollowed by the passage of centuries, its gnarled bark a testament to its age. Some round flower beds bursting with vibrant red, purple, and orange flowers are encircling the lake and the tree.

On the eastern side of the room, separated by a couple of steps decorated with flowers and candles, there is a secluded perfume-making area. Here, counters are crowded with the tools and equipment necessary for crafting fragrant elixirs, while ceramic amphorae are stored beneath, likely to store finished scents. The area leads to a gate covered in vines and flowers, making passage through it impossible.

>x
What do you want to examine?

>investigate
In the Secret Garden you see a statue of a man, a lake, an olive tree and some flowerbeds with red, purple and orange flowers. In the perfume-making area there are some ceramic amphorae and a gate.

>g
In the Secret Garden you see a statue of a man, a lake, an olive tree and some flowerbeds with red, purple and orange flowers. In the perfume-making area there are some ceramic amphorae and a gate.

>g
In the Secret Garden you see a statue of a man, a lake, an olive tree and some flowerbeds with red, purple and orange flowers. In the perfume-making area there are some ceramic amphorae and a gate.

>x gat
You can't see any such thing.

>x gate
The gate is covered in thick vines, making it impossible to open.

>x vines
The vines are all over the gate, blocking you from trying to open it. Thankfully, they don't look like the poison kind.

>x vine
The vines are all over the gate, blocking you from trying to open it. Thankfully, they don't look like the poison kind.

>take vine
That seems to be a part of the ivy gate.

>take vines
That seems to be a part of the ivy gate.

>x
What do you want to examine?

>l
Secret Garden
You find yourself in an enchanted underground garden, where magic seems to pulse from every corner. The air is thick with the intoxicating scent of flowers, each blossom radiating a soft, ethereal glow. Though deep beneath the earth, the space is bathed in a gentle, divine light radiating from the plants themselves, complemented by the soft flicker of the candles lining the paths, their wax bodies somehow untouched by time or flame. Despite the absence of any other life, the garden feels alive, giving the impression it exists in a suspended moment between the past and present.

As one steps through the entrance, their eyes would be immediately drawn to a statue of an incomprehensibly beautiful man, poised on a marble base. His right hand is raised, his gaze fixed intently on it, as if beholding some unseen object. Behind the statue lies a serene natural lake, with delicate pink and white lilies gently laying on its surface. On the other side of the water, a majestic olive tree stands, ancient and hollowed by the passage of centuries, its gnarled bark a testament to its age. Some round flower beds bursting with vibrant red, purple, and orange flowers are encircling the lake and the tree.

On the eastern side of the room, separated by a couple of steps decorated with flowers and candles, there is a secluded perfume-making area. Here, counters are crowded with the tools and equipment necessary for crafting fragrant elixirs, while ceramic amphorae are stored beneath, likely to store finished scents. The area leads to a gate covered in vines and flowers, making passage through it impossible.

>g
Secret Garden
You find yourself in an enchanted underground garden, where magic seems to pulse from every corner. The air is thick with the intoxicating scent of flowers, each blossom radiating a soft, ethereal glow. Though deep beneath the earth, the space is bathed in a gentle, divine light radiating from the plants themselves, complemented by the soft flicker of the candles lining the paths, their wax bodies somehow untouched by time or flame. Despite the absence of any other life, the garden feels alive, giving the impression it exists in a suspended moment between the past and present.

As one steps through the entrance, their eyes would be immediately drawn to a statue of an incomprehensibly beautiful man, poised on a marble base. His right hand is raised, his gaze fixed intently on it, as if beholding some unseen object. Behind the statue lies a serene natural lake, with delicate pink and white lilies gently laying on its surface. On the other side of the water, a majestic olive tree stands, ancient and hollowed by the passage of centuries, its gnarled bark a testament to its age. Some round flower beds bursting with vibrant red, purple, and orange flowers are encircling the lake and the tree.

On the eastern side of the room, separated by a couple of steps decorated with flowers and candles, there is a secluded perfume-making area. Here, counters are crowded with the tools and equipment necessary for crafting fragrant elixirs, while ceramic amphorae are stored beneath, likely to store finished scents. The area leads to a gate covered in vines and flowers, making passage through it impossible.

>g
Secret Garden
You find yourself in an enchanted underground garden, where magic seems to pulse from every corner. The air is thick with the intoxicating scent of flowers, each blossom radiating a soft, ethereal glow. Though deep beneath the earth, the space is bathed in a gentle, divine light radiating from the plants themselves, complemented by the soft flicker of the candles lining the paths, their wax bodies somehow untouched by time or flame. Despite the absence of any other life, the garden feels alive, giving the impression it exists in a suspended moment between the past and present.

As one steps through the entrance, their eyes would be immediately drawn to a statue of an incomprehensibly beautiful man, poised on a marble base. His right hand is raised, his gaze fixed intently on it, as if beholding some unseen object. Behind the statue lies a serene natural lake, with delicate pink and white lilies gently laying on its surface. On the other side of the water, a majestic olive tree stands, ancient and hollowed by the passage of centuries, its gnarled bark a testament to its age. Some round flower beds bursting with vibrant red, purple, and orange flowers are encircling the lake and the tree.

On the eastern side of the room, separated by a couple of steps decorated with flowers and candles, there is a secluded perfume-making area. Here, counters are crowded with the tools and equipment necessary for crafting fragrant elixirs, while ceramic amphorae are stored beneath, likely to store finished scents. The area leads to a gate covered in vines and flowers, making passage through it impossible.

I beg your pardon?

>g
Secret Garden
You find yourself in an enchanted underground garden, where magic seems to pulse from every corner. The air is thick with the intoxicating scent of flowers, each blossom radiating a soft, ethereal glow. Though deep beneath the earth, the space is bathed in a gentle, divine light radiating from the plants themselves, complemented by the soft flicker of the candles lining the paths, their wax bodies somehow untouched by time or flame. Despite the absence of any other life, the garden feels alive, giving the impression it exists in a suspended moment between the past and present.

As one steps through the entrance, their eyes would be immediately drawn to a statue of an incomprehensibly beautiful man, poised on a marble base. His right hand is raised, his gaze fixed intently on it, as if beholding some unseen object. Behind the statue lies a serene natural lake, with delicate pink and white lilies gently laying on its surface. On the other side of the water, a majestic olive tree stands, ancient and hollowed by the passage of centuries, its gnarled bark a testament to its age. Some round flower beds bursting with vibrant red, purple, and orange flowers are encircling the lake and the tree.

On the eastern side of the room, separated by a couple of steps decorated with flowers and candles, there is a secluded perfume-making area. Here, counters are crowded with the tools and equipment necessary for crafting fragrant elixirs, while ceramic amphorae are stored beneath, likely to store finished scents. The area leads to a gate covered in vines and flowers, making passage through it impossible.

>investigate
In the Secret Garden you see a statue of a man, a lake, an olive tree and some flowerbeds with red, purple and orange flowers. In the perfume-making area there are some ceramic amphorae and a gate.

* * *

>g
In the Secret Garden you see a statue of a man, a lake, an olive tree and some flowerbeds with red, purple and orange flowers. In the perfume-making area there are some ceramic amphorae and a gate.

>x
What do you want to examine?

>g
You can't see any such thing.

>g
You can't see any such thing.

>inventory
You are carrying nothing.

>g
You are carrying nothing.

>a
That's not a verb I recognise.

>again
That's not a verb I recognise.

>i
You are carrying nothing.

>a
That's not a verb I recognise.

>i
You are carrying nothing.

>again
You are carrying nothing.

>g
You are carrying nothing.

>investigate
In the Secret Garden you see a statue of a man, a lake, an olive tree and some flowerbeds with red, purple and orange flowers. In the perfume-making area there are some ceramic amphorae and a gate.

>x amphorae
There are three amphorae placed under the counter. They are ceramic and on them are depicted scenes painted with thin strokes of golden paint, showcasing excelent craftstmanship. The scenes portray the proccess of perfume making.
 You notice that all of them are a bit dusty, but one - the one on the right.

>x left amphora
This amphora depicts a scene of women making perfume using rose extracts. It is filled halfway with perfume.

>x central amphora
You can't see any such thing.

>x right amphora
This amphora depicts a scene of two women picking roses. It is empty.

>x second amphora
This amphora depicts a scene of women preparing roses for the perfume-making process. It is filled halfway with perfume.

>x first amphora
This amphora depicts a scene of two women picking roses. It is empty.

>x second amphora
This amphora depicts a scene of women preparing roses for the perfume-making process. It is filled halfway with perfume.

>x third amphora
This amphora depicts a scene of women making perfume using rose extracts. It is filled halfway with perfume.

>x sign
The inscription on it reads: 

 May our love root and grow eternally, even though I am but mortal.
 I am afraid I will pass from this world still holding on to the bittersweet memory of you.
 Even in our parting I will find solace in your scent.

>take red flower from right amphora
You picked up a red flower.

>x lake
It's a beautiful lake full of pink and white water lilies sitting on its surface.

>x lillies
You can't see any such thing.

>x water lilly
I only understood you as far as wanting to examine the water lily.

>x water lily
It's a cute pink flower.

>i
You are carrying:
  a red flower

>x red flower
The red flowers have vibrant, silky petals, coloured in deep red. Their petals surround a small, central cluster of tiny, golden yellow stamens, and are set against feathery, soft green leaves that are thin and finely divided, almost like delicate threads. These are Adonis flowers. In the language of flowers, they signify sorrowful memories and the transience of life.

>investigate
In the Secret Garden you see a statue of a man, a lake, an olive tree and some flowerbeds with red, purple and orange flowers. In the perfume-making area there are some ceramic amphorae and a gate.

>x purple flower
The purple flowers have tall, graceful stalks adorned with dense clusters of tiny, deep purple blossoms that cascade like flowing velvet. Their leaves are broad and slightly textured, with a rich green color that complements the vibrant blooms. These are Amaranthos flowers. In the language of flowers, they signify immortality, unfading love, and eternal beauty.

>x orange flower
The orange flowers have bright, fiery orange clusters of small, star-shaped flowers that stand out against their narrow, dark green leaves. The blossoms are arranged in flat-topped clusters, giving the plant a vibrant, bushy appearance. These are Butterfly Weed flowers. In the language of flowers, they signify a longing for release, letting go and parting.

>x pink flower
You can't see any such thing.

>x water lily
It's a cute pink flower.

>x sign
The inscription on it reads: 

 May our love root and grow eternally, even though I am but mortal.
 I am afraid I will pass from this world still holding on to the bittersweet memory of you.
 Even in our parting I will find solace in your scent.

>put red flower in statue hand
I only understood you as far as wanting to put the red flower in the man statue.

>put red fower in the man statue
I didn't understand that sentence.

>x statue
The statue depicts a man with breathtaking beauty. His figure is carved with exquisite detail, and his chiseled features and graceful form are captured with masterful artistry. There is a longingness in his gaze, which falls on his raised right hand.

His right hand looks like it could be holding something but there's nothing there.

>put red flower in hand
You place the red flower in the statue's right hand.

>x left amphora
This amphora depicts a scene of women making perfume using rose extracts. It is filled halfway with perfume.

* * *

>x central amphora
You can't see any such thing.

>x second amphora
This amphora depicts a scene of women preparing roses for the perfume-making process. It is filled halfway with perfume.

>x right amphora
This amphora depicts a scene of two women picking roses. It is empty.

>x purple flower in cavity
You can't see any such thing.

>put purple flower in cavity
(first taking the purple flower)
You picked up a purple flower.

You put the purple flower into the tree cavity.

>x sign
The inscription on it reads: 

 May our love root and grow eternally, even though I am but mortal.
 I am afraid I will pass from this world still holding on to the bittersweet memory of you.
 Even in our parting I will find solace in your scent.

>x orange flower
The orange flowers have bright, fiery orange clusters of small, star-shaped flowers that stand out against their narrow, dark green leaves. The blossoms are arranged in flat-topped clusters, giving the plant a vibrant, bushy appearance. These are Butterfly Weed flowers. In the language of flowers, they signify a longing for release, letting go and parting.

>put orange flower in right amphora
(first taking the orange flower)
You picked up an orange flower.

You put the orange flower into the right amphora.

You hear the sound of leaves rustling.

>go in gate
(first opening the ivy gate)

Divine Cell 4
devine cell 4 description TODO

* * *

>l
Temple of the Aulidean Artemis
Inside the Temple of the Aulidean Artemis you can see a sundial, the statue of Artemis and her sacrificial altar.

>l
Temple of the Aulidean Artemis
Inside the Temple of the Aulidean Artemis you can see a sundial, the statue of Artemis and her sacrificial altar.

* * *

>take lake
That's fixed in place.

>pickup water from lake
That's not a verb I recognise.

>take water from lake
You can't see any such thing.

>l
Secret Garden
You are in the Secret Garden

You see a lake.

A heavy looking gate that seems to lead to the next room is on the eastern side of the garden, its view obstructed by vines and flowers.

You find yourself before a flowerbed with intense red flowers...

a flowerbed with beautiful purple flowers...

a flowerbed with vibrant yellow flowers...

and a flowerbed with pretty white flowers.

In the garden you see a statue of a beautiful man.

You can also see a container B (empty), a container C (empty) and a container D (empty) here.

>e
(first opening the puzzle gate)
It isn't something you can open.

>pickup vinesd
That's not a verb I recognise.

>take vines
You can't see any such thing.

>e flowerbed
I only understood you as far as wanting to (go) east.

>x flowerbed
Which do you mean, the red flowerbed, the purple flowerbed, the yellow flowerbed or the white flowerbed?

>x red flowerbed
You can see some red flowers in this flowerbed.

In the red flowerbed are ten red flowers.

>take flowers
red flower: You picked up a red flower.
red flower: You picked up a red flower.
red flower: You picked up a red flower.
red flower: You picked up a red flower.
red flower: You picked up a red flower.
red flower: You picked up a red flower.
red flower: You picked up a red flower.
red flower: You picked up a red flower.
red flower: You picked up a red flower.
red flower: You picked up a red flower.
purple flower: You picked up a purple flower.
purple flower: You picked up a purple flower.
purple flower: You picked up a purple flower.
purple flower: You picked up a purple flower.
purple flower: You picked up a purple flower.
purple flower: You picked up a purple flower.
purple flower: You picked up a purple flower.
purple flower: You picked up a purple flower.
purple flower: You picked up a purple flower.
purple flower: You picked up a purple flower.
yellow flower: You picked up a yellow flower.
yellow flower: You picked up a yellow flower.
yellow flower: You picked up a yellow flower.
yellow flower: You picked up a yellow flower.
yellow flower: You picked up a yellow flower.
yellow flower: You picked up a yellow flower.
yellow flower: You picked up a yellow flower.
yellow flower: You picked up a yellow flower.
yellow flower: You picked up a yellow flower.
yellow flower: You picked up a yellow flower.
white flower: You picked up a white flower.
white flower: You picked up a white flower.
white flower: You picked up a white flower.
white flower: You picked up a white flower.
white flower: You picked up a white flower.
white flower: You picked up a white flower.
white flower: You picked up a white flower.
white flower: You picked up a white flower.
white flower: You picked up a white flower.
white flower: You picked up a white flower.

>l
Secret Garden
You are in the Secret Garden

You see a lake.

A heavy looking gate that seems to lead to the next room is on the eastern side of the garden, its view obstructed by vines and flowers.

You find yourself before a flowerbed with intense red flowers...

a flowerbed with beautiful purple flowers...

a flowerbed with vibrant yellow flowers...

and a flowerbed with pretty white flowers.

In the garden you see a statue of a beautiful man.

You can also see a container B (empty), a container C (empty) and a container D (empty) here.

>i
You are carrying:
  ten white flowers
  ten yellow flowers
  ten purple flowers
  ten red flowers

>x white flowers
You can't use multiple objects with that verb.

>x white flower
This is an Bilberry Flower.  In the flower tongue it means "let me go".

>x yellow flower
This is an Chrysanthemum Flower.  It is said to signify treachery.

>x red flower
This is an Adonis Flower.It is said to signify painful memories.

>x purple flower
This is an Amaranthos Flower.  It is said to signify unfading love.

>l
Secret Garden
You are in the Secret Garden

You see a lake.

A heavy looking gate that seems to lead to the next room is on the eastern side of the garden, its view obstructed by vines and flowers.

You find yourself before a flowerbed with intense red flowers...

a flowerbed with beautiful purple flowers...

a flowerbed with vibrant yellow flowers...

and a flowerbed with pretty white flowers.

In the garden you see a statue of a beautiful man.

You can also see a container B (empty), a container C (empty) and a container D (empty) here.

>x statue
You find a marble sign on the statue's base. His right hand looks like it could be holding something but there's nothing there. You notice the Greek number A on the statue.

>x sign
The inscription on it reads: Painful memories of our love surround this place. (A > red, B > purple, C> yellow, D>white)

>take hands
You can't see any such thing.

>put red flower in hands
You can't see any such thing.

>put red flower in hand
You place the red flower in the statue's right hand.

>take hand
That seems to be a part of the statue.

>x purple container
You picked up every purple flower.

>x purple flowerbed
You picked up every purple flower.

>take purple container
That's fixed in place.

>x container b
The container B is empty.

>x sign
The inscription on it reads: Painful memories of our love surround this place. (A > red, B > purple, C> yellow, D>white)

>put purple flower in container b
You put the purple flower into the container B.

>test me
(Testing.)

>[1] put red flower in hands
You can't see any such thing.

>[2] put purple flower in b
There is no more room in the container B.

>[3] put yellow flower in c
You put the yellow flower into the container C.

>[4] put white flower in d
(the container D)
You put the white flower into the container D.

You hear the sound of the gate opening
>[5] x gate
The puzzle gate is now open.

>[6] take red flower from hands
You can't see any such thing.

>[7] go e

Divine Cell 4
You see the gods sleeping

You see a lake.

A heavy looking gate that seems to lead to the next room is on the eastern side of the garden, its view obstructed by vines and flowers.

You can also see Aphrodite and Hephaestus here.

>w]
That's not a verb I recognise.

>w
Secret Garden
You are in the Secret Garden

You see a lake.

A heavy looking gate that seems to lead to the next room is on the eastern side of the garden, its view obstructed by vines and flowers.

You find yourself before a flowerbed with intense red flowers...

a flowerbed with beautiful purple flowers...

a flowerbed with vibrant yellow flowers...

and a flowerbed with pretty white flowers.

In the garden you see a statue of a beautiful man.

You can also see a container B (in which is a purple flower), a container C (in which is a yellow flower) and a container D (in which is a white flower) here.

>go to lake
You can't see any such thing.

>l
Secret Garden
You are in the Secret Garden

You see a lake.

A heavy looking gate that seems to lead to the next room is on the eastern side of the garden, its view obstructed by vines and flowers.

You find yourself before a flowerbed with intense red flowers...

a flowerbed with beautiful purple flowers...

a flowerbed with vibrant yellow flowers...

and a flowerbed with pretty white flowers.

In the garden you see a statue of a beautiful man.

You can also see a container B (in which is a purple flower), a container C (in which is a yellow flower) and a container D (in which is a white flower) here.

>go in lake
You swim through the waters.

>d
Divine Cell 4
You see the gods sleeping

You see a lake.

A heavy looking gate that seems to lead to the next room is on the eastern side of the garden, its view obstructed by vines and flowers.

You can also see Aphrodite and Hephaestus here.

>e
You can't go that way.

>w
Secret Garden
You are in the Secret Garden

You see a lake.

A heavy looking gate that seems to lead to the next room is on the eastern side of the garden, its view obstructed by vines and flowers.

You find yourself before a flowerbed with intense red flowers...

a flowerbed with beautiful purple flowers...

a flowerbed with vibrant yellow flowers...

and a flowerbed with pretty white flowers.

In the garden you see a statue of a beautiful man.

You can also see a container B (in which is a purple flower), a container C (in which is a yellow flower) and a container D (in which is a white flower) here.

>go in lake
You swim through the waters.

>w
You can't go that way.

>d
Divine Cell 4
You see the gods sleeping

You see a lake.

A heavy looking gate that seems to lead to the next room is on the eastern side of the garden, its view obstructed by vines and flowers.

You can also see Aphrodite and Hephaestus here.

>u
Secret Garden
You are in the Secret Garden

You see a lake.

A heavy looking gate that seems to lead to the next room is on the eastern side of the garden, its view obstructed by vines and flowers.

You find yourself before a flowerbed with intense red flowers...

a flowerbed with beautiful purple flowers...

a flowerbed with vibrant yellow flowers...

and a flowerbed with pretty white flowers.

In the garden you see a statue of a beautiful man.

You can also see a container B (in which is a purple flower), a container C (in which is a yellow flower) and a container D (in which is a white flower) here.

>u
Throne Room
Home to the King of Paphos, Cinyras.

You can see Cinyras here.

>u
You can't go that way.

>d
Secret Garden
You are in the Secret Garden

You see a lake.

A heavy looking gate that seems to lead to the next room is on the eastern side of the garden, its view obstructed by vines and flowers.

You find yourself before a flowerbed with intense red flowers...

a flowerbed with beautiful purple flowers...

a flowerbed with vibrant yellow flowers...

and a flowerbed with pretty white flowers.

In the garden you see a statue of a beautiful man.

You can also see a container B (in which is a purple flower), a container C (in which is a yellow flower) and a container D (in which is a white flower) here.

>d
Divine Cell 4
You see the gods sleeping

You see a lake.

A heavy looking gate that seems to lead to the next room is on the eastern side of the garden, its view obstructed by vines and flowers.

You can also see Aphrodite and Hephaestus here.

* * *

>eat lake
That's plainly inedible.

>lake
That's not a verb I recognise.

>lake lake
That's not a verb I recognise.

>p
That's not a verb I recognise.

>d
Divine Cell 4
You see the gods sleeping

You see a lake.

A heavy looking gate that seems to lead to the next room is on the eastern side of the garden, its view obstructed by vines and flowers.

You can also see Aphrodite and Hephaestus here.

>w
Secret Garden
You are in the Secret Garden

You see a lake.

A heavy looking gate that seems to lead to the next room is on the eastern side of the garden, its view obstructed by vines and flowers.

You find yourself before a flowerbed with intense red flowers...

a flowerbed with beautiful purple flowers...

a flowerbed with vibrant yellow flowers...

and a flowerbed with pretty white flowers.

In the garden you see a statue of a beautiful man.

You can also see a container B (in which is a purple flower), a container C (in which is a yellow flower) and a container D (in which is a white flower) here.

>u
Throne Room
Home to the King of Paphos, Cinyras.

You can see Cinyras here.

>d
Secret Garden
You are in the Secret Garden

You see a lake.

A heavy looking gate that seems to lead to the next room is on the eastern side of the garden, its view obstructed by vines and flowers.

You find yourself before a flowerbed with intense red flowers...

a flowerbed with beautiful purple flowers...

a flowerbed with vibrant yellow flowers...

and a flowerbed with pretty white flowers.

In the garden you see a statue of a beautiful man.

You can also see a container B (in which is a purple flower), a container C (in which is a yellow flower) and a container D (in which is a white flower) here.

* * *

>d
Divine Cell 4
You see the gods sleeping

You see a lake.

A heavy looking gate that seems to lead to the next room is on the eastern side of the garden, its view obstructed by vines and flowers.

You can also see Aphrodite and Hephaestus here.

>d
You can't go that way.

* * *

I beg your pardon?

>d
You can't go that way.

>o
Sorry, that can't be corrected.

>s
You can't go that way.

>w
Secret Garden
You are in the Secret Garden

You see a lake.

A heavy looking gate that seems to lead to the next room is on the eastern side of the garden, its view obstructed by vines and flowers.

You find yourself before a flowerbed with intense red flowers...

a flowerbed with beautiful purple flowers...

a flowerbed with vibrant yellow flowers...

and a flowerbed with pretty white flowers.

In the garden you see a statue of a beautiful man.

You can also see a container B (in which is a purple flower), a container C (in which is a yellow flower) and a container D (in which is a white flower) here.

>d
Divine Cell 4
You see the gods sleeping

You see a lake.

A heavy looking gate that seems to lead to the next room is on the eastern side of the garden, its view obstructed by vines and flowers.

You can also see Aphrodite and Hephaestus here.

>a
That's not a verb I recognise.

* * *

>take vines
You picked up a vines.

>take vines
You already have that.

>i
You are carrying:
  a vines
  an aria

>c aria
That's not a verb I recognise.

>x aria
You see nothing special about the aria.

>x vines
They're just some vines

>eat vines
That's plainly inedible.

>fake
That's not a verb I recognise.

>put vines in lake
That can't contain things.

>take lake
That's fixed in place.

>l
Secret Garden
You are in the Secret Garden. In your right you can see some golden amphorae. In the middle of the garden you see an enormous tree with a cavity in the middle

You see a lake. On its shore you see some seashells.

A heavy looking gate that seems to lead to the next room is on the eastern side of the garden, its view mostly obstructed by vines and flowers.

In the garden you see a statue of a beautiful man.

>take flowers
red flower: You picked up a red flower.
red flower: You picked up a red flower.
red flower: You picked up a red flower.
red flower: You picked up a red flower.
red flower: You picked up a red flower.
red flower: You picked up a red flower.
red flower: You picked up a red flower.
red flower: You picked up a red flower.
red flower: You're carrying too many things already.
red flower: You're carrying too many things already.
purple flower: You're carrying too many things already.
purple flower: You're carrying too many things already.
purple flower: You're carrying too many things already.
purple flower: You're carrying too many things already.
purple flower: You're carrying too many things already.
purple flower: You're carrying too many things already.
purple flower: You're carrying too many things already.
purple flower: You're carrying too many things already.
purple flower: You're carrying too many things already.
purple flower: You're carrying too many things already.
yellow flower: You're carrying too many things already.
yellow flower: You're carrying too many things already.
yellow flower: You're carrying too many things already.
yellow flower: You're carrying too many things already.
yellow flower: You're carrying too many things already.
yellow flower: You're carrying too many things already.
yellow flower: You're carrying too many things already.
yellow flower: You're carrying too many things already.
yellow flower: You're carrying too many things already.
yellow flower: You're carrying too many things already.
white flower: You're carrying too many things already.
white flower: You're carrying too many things already.
white flower: You're carrying too many things already.
white flower: You're carrying too many things already.
white flower: You're carrying too many things already.
white flower: You're carrying too many things already.
white flower: You're carrying too many things already.
white flower: You're carrying too many things already.
white flower: You're carrying too many things already.
white flower: You're carrying too many things already.

* * *

>test
>--> The following tests are available:
'test cad'
'test gate'
'test pos'
'test art'
'test fire'

>test cad
(Testing.)

>[1] x dragon statue
A small statue depicting a dragon. It is masterfully sculpted, with meticulous attention evident in every detail. Each scale is rendered with such precision that they appear almost lifelike, giving the dragon a sense of realism. 

The statue's mouth is closed.

>[2] put rock on dragon head
(first taking the rock)
You picked up a rock.

You put the rock on the dragon head.

You hear the sound of stone grinding against stone. The dragon statue's mouth opened.

>[3] x dragon statue
A small statue depicting a dragon. It is masterfully sculpted, with meticulous attention evident in every detail. Each scale is rendered with such precision that they appear almost lifelike, giving the dragon a sense of realism. 

 You see 6 tooth inside the statue's mouth.

>[4] take 6 dragon teeth
dragon tooth: You picked up a dragon tooth.
dragon tooth: You picked up a dragon tooth.
dragon tooth: You picked up a dragon tooth.
dragon tooth: You picked up a dragon tooth.
dragon tooth: You picked up a dragon tooth.
dragon tooth: You picked up a dragon tooth.

>[5] put 6 dragon teeth in the plate
dragon tooth: Done.
dragon tooth: Done.
dragon tooth: Done.
dragon tooth: Done.
dragon tooth: Done.
dragon tooth: Done.

The dragon teeth are syphoned into the altar and a compartment door opens, exposing 6 weights.

>test gate
(Testing.)

>[1] take weights
owl weight: You picked up an owl weight.
shield weight: You picked up a shield weight.
spear weight: You picked up a spear weight.
snake weight: You picked up a snake weight.
sword weight: You picked up a sword weight.
horse weight: You picked up a horse weight.

>[2] put owl weight on first pan
You put the owl weight on the first pan.

>[3] put snake weight on second pan
You put the snake weight on the second pan.

>[4] put sword weight on third pan
You put the sword weight on the third pan.

>[5] put shield weight on 4th pan
You put the shield weight on the fourth pan.

>[6] put spear sweight on 5th pan
I didn't understand that sentence.

>[7] put horse on 6th pan
You put the horse weight on the sixth pan.

>go in gate
(first opening the dragon gate)
It seems to be locked.

>x gate
The gate is locked.

>put spear weight on 5th pan
You put the spear weight on the fifth pan.

You hear the sound of the gate mechanism unlocking

>enter gate
(first opening the dragon gate)

Divine Cell 1

>out
But you aren't in anything at the moment.

* * *

>test fire
(Testing.)

>[1] light second torch
You picked up the portable torch.

You lighted the second torch using the portable torch.

>[2] light third torch
You lighted the third torch using the portable torch.

>[3] light sixth torch
You lighted the sixth torch using the portable torch.

>[4] light seventh torch
You lighted the seventh torch using the portable torch.

>[5] light eighth torch
You lighted the eighth torch using the portable torch.

>[6] light tenth torch
You lighted the tenth torch using the portable torch.

>[7] light eleventh torch
You lighted the eleventh torch using the portable torch.

>[8] light thirteenth torch
You lighted the thirteenth torch using the portable torch.

>[9] light fourteent torch
You lighted the fourteenth torch using the portable torch.

>[10] light fifteenth torch
You lighted the fifteenth torch using the portable torch.

>[11] light sixteenth torch
You lighted the sixteenth torch using the portable torch.

You hear the sound of something unlocking.

* * *

>x main hall
You can't see any such thing.

>x hall
You can't see any such thing.

>x hearth
You see nothing special about the hearth.

>x table
A large, pine table, likely reserved for thr official dinners and gatherings of the prytaneis.

>take table
The table is to heavy for you to lift!

>x chair
The chairs are a matching set with the table, all crafted of pine.

>take chair
You don't think carrying a pine chair will help you on your journey.

>smell chair
It smells neutral.

>smell table
It smells neutral.

>l
Prytaneion
You step into the open hall of the Prytaneion, the administrative heart of Athens. In the center of the room you see the sacred hearth dedicated to Hestia, its warm glow illuminating the room. The flames burn steadily, their smoke rising in delicate spirals before disappearing through a square opening in the roof above. Beside the hearth lies a single hand torch, accompanied by a fire snuffer.

Just beyond the hearth, there is a small dining area. A large table made of pine, surrounded by several chairs, stands atop an elegant carpet, likely reserved for official dinners and gatherings. Scattered across the table are an empty scroll, a wax tablet, a papyrus scroll and a parchment scroll, remnants of a recent meeting, perhaps.

Eight torches on either side of the hearth are placed on the ground, forming a semicircle around the dining area. The torches are all put out, from the first-the far left one-to the sixteenth-the far right one.

The rest of the building remains inaccessible, since the doors lead to the private quarters of the prytaneis and thus are firmly locked, leaving the main hall as the only accessible space.

>x carpet
An elegant red carpet. When you step on it to inspect it further, you hear creaking.

>take carpet
You can't take the carpet if there are things on top of it.

>move table
You put all your strength into pushing the table off the carpet- and you manage it!

>move chair
You push the chairs off the carpet.

>move chair
You push the chairs off the carpet.

>g
You push the chairs off the carpet.

>g
You push the chairs off the carpet.

I beg your pardon?

>g
You push the chairs off the carpet.

>move table
You put all your strength into pushing the table off the carpet- and you manage it!

>g
You put all your strength into pushing the table off the carpet- and you manage it!

>g
You put all your strength into pushing the table off the carpet- and you manage it!

I beg your pardon?

>g
You put all your strength into pushing the table off the carpet- and you manage it!

>l
Prytaneion
You step into the open hall of the Prytaneion, the administrative heart of Athens. In the center of the room you see the sacred hearth dedicated to Hestia, its warm glow illuminating the room. The flames burn steadily, their smoke rising in delicate spirals before disappearing through a square opening in the roof above. Beside the hearth lies a single hand torch, accompanied by a fire snuffer.

Just beyond the hearth, there is a small dining area. A large table made of pine, surrounded by several chairs, stands atop an elegant carpet, likely reserved for official dinners and gatherings. Scattered across the table are an empty scroll, a wax tablet, a papyrus scroll and a parchment scroll, remnants of a recent meeting, perhaps.

Eight torches on either side of the hearth are placed on the ground, forming a semicircle around the dining area. The torches are all put out, from the first-the far left one-to the sixteenth-the far right one.

The rest of the building remains inaccessible, since the doors lead to the private quarters of the prytaneis and thus are firmly locked, leaving the main hall as the only accessible space.

>take table
The table is to heavy for you to lift!

>take chair
You don't think carrying a pine chair will help you on your journey.

>x chair
The chairs are a matching set with the table, all crafted of pine.

>l
Prytaneion
You step into the open hall of the Prytaneion, the administrative heart of Athens. In the center of the room you see the sacred hearth dedicated to Hestia, its warm glow illuminating the room. The flames burn steadily, their smoke rising in delicate spirals before disappearing through a square opening in the roof above. Beside the hearth lies a single hand torch, accompanied by a fire snuffer.

Just beyond the hearth, there is a small dining area. A large table made of pine, surrounded by several chairs, stands atop an elegant carpet, likely reserved for official dinners and gatherings. Scattered across the table are an empty scroll, a wax tablet, a papyrus scroll and a parchment scroll, remnants of a recent meeting, perhaps.

Eight torches on either side of the hearth are placed on the ground, forming a semicircle around the dining area. The torches are all put out, from the first-the far left one-to the sixteenth-the far right one.

The rest of the building remains inaccessible, since the doors lead to the private quarters of the prytaneis and thus are firmly locked, leaving the main hall as the only accessible space.

>take carpet
That's called theft! Refer from it in the future.

>smell carpet
It smells neutral.

>eat carpet
That's plainly inedible.

>burn carpet
This dangerous act would achieve little.

>light carpet
This dangerous act would achieve little.

>x carpet
An elegant red carpet. When you step on it to inspect it further, you hear creaking.

>l
Prytaneion
You step into the open hall of the Prytaneion, the administrative heart of Athens. In the center of the room you see the sacred hearth dedicated to Hestia, its warm glow illuminating the room. The flames burn steadily, their smoke rising in delicate spirals before disappearing through a square opening in the roof above. Beside the hearth lies a single hand torch, accompanied by a fire snuffer.

Just beyond the hearth, there is a small dining area. A large table made of pine, surrounded by several chairs, stands atop an elegant carpet, likely reserved for official dinners and gatherings. Scattered across the table are an empty scroll, a wax tablet, a papyrus scroll and a parchment scroll, remnants of a recent meeting, perhaps.

Eight torches on either side of the hearth are placed on the ground, forming a semicircle around the dining area. The torches are all put out, from the first-the far left one-to the sixteenth-the far right one.

The rest of the building remains inaccessible, since the doors lead to the private quarters of the prytaneis and thus are firmly locked, leaving the main hall as the only accessible space.

>x ground
You can't see any such thing.

>move carpet
You pulled the carpet
By pulling the carpet out of the way you revealed a trapdoor.

>x trapdoor
The trapdoor is unlocked now.

By pulling the carpet out of the way you revealed a trapdoor.

>go in trapdoor
(first opening the trapdoor)
It seems to be locked.

By pulling the carpet out of the way you revealed a trapdoor.

>showme 2nd torch
second torch - second torch
location: in Prytaneion
lit, inedible, fixed in place; singular-named, improper-named
description: none
initial appearance: none
smell: neutral
printed name: "second torch"
printed plural name: "second torches"
indefinite article: none
list grouping key: none

* * *

>unlock sun lock
You need a matching sun key for this lock.

>unlock statue
It seems like you need 2 keys for the locks to unlock.

>wait untill midday
I only understood you as far as wanting to wait.

>wait until midday
It is twelve o'clock now.

At twelve o'clock you hear the sound of a hatch opening on the dial.

>take sun key
You picked up a sun key.

>unlock statue
You put the sun key in the sun-shapped lock.

It seems like you need one more key.

>x sun lock
The sun key is in the sun-shapped lock

* * *

>w
Agora of Sounio

>n
Gates of Sounio
To the south you can see the town of Sounio. 

From here you can travel to: 
→ Athens

>nw
You can't go that way.

>e
You can't go that way.

* * *

>n
You can't go that way.

>nw
You can't go that way.

>travel to athens
Which do you mean, Northen Gates of Athens or Southern Gates of Athens?

>northen gates of athens
You cannot travel directly to the Northen Gates of Athens from here.

>travel to southern gates of athens
You travel to the Southern Gates of Athens.

Southern Gates of Athens
To the northwest you can see the city of Athens. 

From here you can travel to: 
→ Sounio

>n
You can't go that way.

>nw
Agora of Athens

>ne
You can't go that way.

>n
Northen Gates of Athens
To the south you can see the city of Athens. 

From here you can travel to: 
→ Thebes
→ Aulis
→ Delphi
→ Ephyra
→ Mount Olympus

>travel to aulis
You travel to the Gates of Aulis.

Gates of Aulis
To the north you can see the town of Aulis. 

From here you can travel to: 
→ Thebes
→ Athens
→  Delphi
→ Ephyra
→ Mount Olympus

>n
Agora of Aulis

>go in temple
You went into the temple of the aulidean artemis
Temple of the Aulidean Artemis
Inside the Temple of the Aulidean Artemis you can see a sundial, the statue of Artemis and her sacrificial altar.

>x dial
They showcase sun and lunar markings, allowing you to use the dial to read the time day and night.

>wait until middnight
I only understood you as far as wanting to wait.

>wait until midnight
At twelve o'clock  you hear the click of a latch releasing and a sun hatch opening coming from the dial.

At ten past twelve you hear the sound of the sun hatch closing and the click of a latch locking coming from the dial.

The day passes.

It is twelve o'clock now.

At twelve o'clock you hear the click of a latch releasing and a moon hatch opening coming from the dial.

>x dial
They showcase sun and lunar markings, allowing you to use the dial to read the time day and night.

>wait until 4 am
It is four o'clock now.

>wait until 12 pm
It is twelve o'clock now.

>wait until 11 pm
It is eleven o'clock now.

>wait until 12 pm
It is twelve o'clock now.

>wait until 1 pm
It is one o'clock now.

>scene
That's not a verb I recognise.

>scenes
Scene 'Entire Game' playing (for -533 mins now)
Scene 'Day' playing (for 7 mins now)
Scene 'Night' ended
(Scene monitoring now switched on. Type "scenes off" to switch it off again.)

>wait until 4 pm
It is four o'clock now.

>scenes
Scene 'Entire Game' playing (for -532 mins now)
Scene 'Day' playing (for 8 mins now)
Scene 'Night' ended
(Scene monitoring now switched on. Type "scenes off" to switch it off again.)

>wait until 2 am
At ten past twelve you hear the sound of the moon hatch closing and the click of a latch locking coming from the dial.

It is two o'clock now.

>scenes
Scene 'Entire Game' playing (for -419 mins now)
Scene 'Day' playing (for 121 mins now)
Scene 'Night' ended
(Scene monitoring now switched on. Type "scenes off" to switch it off again.)

* * *

>wait 12 hours
At twelve o'clock  you hear the click of a latch releasing and a sun hatch opening coming from the dial.

At ten past twelve you hear the sound of the sun hatch closing and the click of a latch locking coming from the dial.

It is now around nine o'clock

>x sundial
The dial is designed with two separate rings encircling its plate, one with sun and one with lunar markings, allowing you to read the time day and night. You also see on the gnomon an inscription engraved and gilded in gold that says: At midday, let Apollo's light cast a shadow, and at midnight, let Artemis' glow guide the way. Only then shall the twins unveil the hidden path.

Judging by the gnomon's shadow and the moon markings, the time is nine o'clock.

* * *

>x
What do you want to examine?

>x dvgate
You see nothing special about the dvgate.

>x rock
You see nothing special about the rock.

>x walls
On the temple walls, the legendary tale of Cadmus is immortalized: he bravely confronts the fearsome Dragon of Ismenus, guardian of Ares" sacred spring, slaying the beast with a rock on the head. After sacrificing to Athena, guided by her wisdom, he buries the dragon's teeth into the earth, from which arise the Spartoi-warriors born from the dragon's teeth, who soon battle amongst themselves.

>x dragon
(dragon statue)
The statue's mouth is closed.

>open mouth
It isn't something you can open.

>take teeth
You can't see any such thing.

>x
What do you want to examine?

>l
Cadmea
on the walls you can see the story of cadmus, who slayed the Dragon of Ismenus and burried his teeth for the Spartoi to sprink from the ground. In front of you is a stone dragon statue, and a big chess board with some chess pieces already on top. You can see a sacrificial plate on top of the altar.

You can see a dvgate, a rock, a walls, dragon statue, a cadmea altar and a scale here.

>x dragon statue
The statue's mouth is closed.

>open mouthj
You can't see any such thing.

>open mouth
It isn't something you can open.

>take mouth
That seems to be a part of dragon statue.

>take dragon statue
That's fixed in place.

* * *

>take walls
That's fixed in place.

>take rock
You picked up a rock.

* * *

>i
You are carrying:
  a rock

>x rock
You see nothing special about the rock.

>take dvgate
That's fixed in place.

>l
Cadmea
on the walls you can see the story of cadmus, who slayed the Dragon of Ismenus and burried his teeth for the Spartoi to sprink from the ground. In front of you is a stone dragon statue, and a big chess board with some chess pieces already on top. You can see a sacrificial plate on top of the altar.

You can see a dvgate, a walls, dragon statue, a cadmea altar and a scale here.

>x cadmea
You see nothing special about the cadmea altar.

>take cadme
You can't see any such thing.

>take cadmea
That's fixed in place.

>x cadmea
You see nothing special about the cadmea altar.

>x altar
You see nothing special about the cadmea altar.

>x scale
You see nothing special about the scale.

>take scale
That's fixed in place.

>i
You are carrying:
  a rock

>put rock on dragon statue
Putting things on dragon statue would achieve nothing.

>x dragon head
You see nothing special about the dragon head.

>put rock on dragon haed
You can't see any such thing.

>put rock on dragon head
You put the rock on the dragon head.

The statue's mouth opened.

>x mouth
In the dragon mouth are six dragon teeth.

>x dragon teeth
You can't use multiple objects with that verb.

>take teeth
dragon tooth: You picked up a dragon tooth.
dragon tooth: You picked up a dragon tooth.
dragon tooth: You picked up a dragon tooth.
dragon tooth: You picked up a dragon tooth.
dragon tooth: You picked up a dragon tooth.
dragon tooth: You picked up a dragon tooth.

>l
Cadmea
on the walls you can see the story of cadmus, who slayed the Dragon of Ismenus and burried his teeth for the Spartoi to sprink from the ground. In front of you is a stone dragon statue, and a big chess board with some chess pieces already on top. You can see a sacrificial plate on top of the altar.

You can see a dvgate, a walls, dragon statue, a cadmea altar and a scale here.

>i
You are carrying:
  six dragon teeth

>x dragon tooth
You see nothing special about the dragon tooth.

>l
Cadmea
on the walls you can see the story of cadmus, who slayed the Dragon of Ismenus and burried his teeth for the Spartoi to sprink from the ground. In front of you is a stone dragon statue, and a big chess board with some chess pieces already on top. You can see a sacrificial plate on top of the altar.

You can see a dvgate, a walls, dragon statue, a cadmea altar and a scale here.

>x chessboard
You can't see any such thing.

>x chess
You can't see any such thing.

>x chess board
You can't see any such thing.

>x scale
You see nothing special about the scale.

>l
Cadmea
on the walls you can see the story of cadmus, who slayed the Dragon of Ismenus and burried his teeth for the Spartoi to sprink from the ground. In front of you is a stone dragon statue, and a big chess board with some chess pieces already on top. You can see a sacrificial plate on top of the altar.

You can see a dvgate, a walls, dragon statue, a cadmea altar and a scale here.

>x wall
You can't see any such thing.

>x walls
On the temple walls, the legendary tale of Cadmus is immortalized: he bravely confronts the fearsome Dragon of Ismenus, guardian of Ares" sacred spring, slaying the beast with a rock on the head. After sacrificing to Athena, guided by her wisdom, he buries the dragon's teeth into the earth, from which arise the Spartoi-warriors born from the dragon's teeth, who soon battle amongst themselves.

>put teeth on scale
dragon tooth: Putting things on the scale would achieve nothing.
dragon tooth: Putting things on the scale would achieve nothing.
dragon tooth: Putting things on the scale would achieve nothing.
dragon tooth: Putting things on the scale would achieve nothing.
dragon tooth: Putting things on the scale would achieve nothing.
dragon tooth: Putting things on the scale would achieve nothing.

>x scale
You see nothing special about the scale.

>take teeth
What do you want to take those things from?

>take teeth from scale
You can't see any such thing.

>i
You are carrying:
  six dragon teeth

>;
That's not a verb I recognise.

>l
Cadmea
on the walls you can see the story of cadmus, who slayed the Dragon of Ismenus and burried his teeth for the Spartoi to sprink from the ground. In front of you is a stone dragon statue, and a big chess board with some chess pieces already on top. You can see a sacrificial plate on top of the altar.

You can see a dvgate, a walls, dragon statue, a cadmea altar and a scale here.

>x altar
You see nothing special about the cadmea altar.

>x plate
The sacrificial plate is empty.

>put teeth in plate
dragon tooth: Done.
dragon tooth: Done.
dragon tooth: Done.
dragon tooth: Done.
dragon tooth: Done.
dragon tooth: Done.

The dragon teeth are syphoned into the altar and a compartment door opens, exposing 6 weights.

>l
Cadmea
on the walls you can see the story of cadmus, who slayed the Dragon of Ismenus and burried his teeth for the Spartoi to sprink from the ground. In front of you is a stone dragon statue, and a big chess board with some chess pieces already on top. You can see a sacrificial plate on top of the altar.

You can see a dvgate, a walls, dragon statue, a cadmea altar and a scale here.

>x weights
You can't use multiple objects with that verb.

>take weights
weight1: You picked up a weight1.
weight2: You picked up a weight2.
weight3: You picked up a weight3.
weight4: You picked up a weight4.

>x weight1
You see nothing special about the weight1.

>eat weight1
That's plainly inedible.

>take plate
That seems to be a part of the cadmea altar.

>l
Cadmea
on the walls you can see the story of cadmus, who slayed the Dragon of Ismenus and burried his teeth for the Spartoi to sprink from the ground. In front of you is a stone dragon statue, and a big chess board with some chess pieces already on top. You can see a sacrificial plate on top of the altar.

You can see a dvgate, a walls, dragon statue, a cadmea altar and a scale here.

>put weights on scale
weight4: Putting things on the scale would achieve nothing.
weight3: Putting things on the scale would achieve nothing.
weight2: Putting things on the scale would achieve nothing.
weight1: Putting things on the scale would achieve nothing.

>greece
That's not a verb I recognise.

>regions
That's not a verb I recognise.

>Greece
That's not a verb I recognise.

* * *

>d
You can't go that way.

>w
You can't go that way.

* * *

>open temple door
It isn't something you can open.

>go in temple door
(first opening the temple door)
It isn't something you can open.

>take altar
That's fixed in place.

>put down altar
The altar is already here.

>go in altar
That's not something you can enter.

>ti
That's not a verb I recognise.

>i
You are carrying nothing.

>take altar
That's fixed in place.

>l
Poseidon's Temple
You see a coloumn with 4 rotatable discs. The discs have 5 faces, 4 of them with a picture and one empty. The pictures are the same on each disc and they are in order: Budding olives and fresh green leaves, Green olives growing in size, with fuller leaves, Ripe, darkening olives ready for harvest, some fallen to the ground and Bare branches with a few remaining leaves, the tree in a state of dormancy. The faces towards the altar are all empty.

Altar.

Column that faces the altar.

On the column are top ring, second ring, third ring and bottom ring.

You can also see a temple door here.

>take columns
You can't see any such thing.

>take column
That's fixed in place.

I beg your pardon?

>take top ring
That's fixed in place.

>take rings
What do you want to take those things from?

I beg your pardon?

>l
Poseidon's Temple
You see a coloumn with 4 rotatable discs. The discs have 5 faces, 4 of them with a picture and one empty. The pictures are the same on each disc and they are in order: Budding olives and fresh green leaves, Green olives growing in size, with fuller leaves, Ripe, darkening olives ready for harvest, some fallen to the ground and Bare branches with a few remaining leaves, the tree in a state of dormancy. The faces towards the altar are all empty.

Altar.

Column that faces the altar.

On the column are top ring, second ring, third ring and bottom ring.

You can also see a temple door here.

>x temple door
The gate is tightly closed.

>x altar
You see nothing special about the altar.

>take altar
That's fixed in place.

>x top ring
Its face shows blank.

>x second rin g
I only understood you as far as wanting to examine second ring.

>x second ring
Its face shows blank.

>x third ring
Its face shows blank.

>x bottom ring
Its face shows blank.

>rotate top ring
It is fixed in place.

>rotate top ring clockwise
Now its face shows winter.

>rotate top ring clockwise
Now its face shows fall.

>rotate top ring clockwise
Now its face shows summer.

>rotate top ring clockwise
Now its face shows spring.

>rotate top ring clockwise
Now its face shows blank.

>rotate second ring clockwise
Now its face shows winter.

>rotate second ring clockwise
Now its face shows fall.

>rotate second ring clockwise
Now its face shows summer.

>rotate second ring clockwise
Now its face shows spring.

>rotate second ring clockwise
Now its face shows blank.

>rotate second ring clockwise
Now its face shows winter.

* * *

>rotate second ring clockwise
Now its face shows blank.

>rotate first ring clockwise
That noun did not make sense in this context.

>rotate first ring clockwise
That noun did not make sense in this context.

>rotate top ring clockwise
Now its face shows winter.

* * *

>rotate top ring clockwise
Now its face shows spring.

>rotate second ring clockwise
Now its face shows winter.

* * *

>rotate second ring clockwise
Now its face shows summer.

>rotate third ring clockwise
Now its face shows winter.

>rotate third ring clockwise
Now its face shows fall.

>rotate bottom ring clockwise
Now its face shows winter.

You hear the sound of the door opening

>l
Poseidon's Temple
You see a coloumn with 4 rotatable discs. The discs have 5 faces, 4 of them with a picture and one empty. The pictures are the same on each disc and they are in order: Budding olives and fresh green leaves, Green olives growing in size, with fuller leaves, Ripe, darkening olives ready for harvest, some fallen to the ground and Bare branches with a few remaining leaves, the tree in a state of dormancy. The faces towards the altar are all empty.

Altar.

Column that faces the altar.

On the column are top ring, second ring, third ring and bottom ring.

You can also see a temple door here.

>go in temple door
Divine Cell 2
You see the gods.

You can see a temple door, Poseidon and Demeter here.

>u
Poseidon's Temple
You see a coloumn with 4 rotatable discs. The discs have 5 faces, 4 of them with a picture and one empty. The pictures are the same on each disc and they are in order: Budding olives and fresh green leaves, Green olives growing in size, with fuller leaves, Ripe, darkening olives ready for harvest, some fallen to the ground and Bare branches with a few remaining leaves, the tree in a state of dormancy. The faces towards the altar are all empty.

Altar.

Column that faces the altar.

On the column are top ring, second ring, third ring and bottom ring.

You can also see a temple door here.

>l
Poseidon's Temple
You see a coloumn with 4 rotatable discs. The discs have 5 faces, 4 of them with a picture and one empty. The pictures are the same on each disc and they are in order: Budding olives and fresh green leaves, Green olives growing in size, with fuller leaves, Ripe, darkening olives ready for harvest, some fallen to the ground and Bare branches with a few remaining leaves, the tree in a state of dormancy. The faces towards the altar are all empty.

Altar.

Column that faces the altar.

On the column are top ring, second ring, third ring and bottom ring.

You can also see a temple door here.

>rotate bottom ring clockwise
Now its face shows fall.

You hear the sound of the door closing.

>go in door
(first opening the temple door)
It isn't something you can open.

>rotate bottom ring counterclockwise
Now its face shows winter.

You hear the sound of the door opening

>l
Poseidon's Temple
You see a coloumn with 4 rotatable discs. The discs have 5 faces, 4 of them with a picture and one empty. The pictures are the same on each disc and they are in order: Budding olives and fresh green leaves, Green olives growing in size, with fuller leaves, Ripe, darkening olives ready for harvest, some fallen to the ground and Bare branches with a few remaining leaves, the tree in a state of dormancy. The faces towards the altar are all empty.

Altar.

Column that faces the altar.

On the column are top ring, second ring, third ring and bottom ring.

You can also see a temple door here.

>x altar
You see nothing special about the altar.

* * *

>x golden amphorae
You notice one amphora shine more than the others

>x shining amphora
You can't see any such thing.

>take tree
(the hollow tree)
That's fixed in place.

>take amphorae
That's fixed in place.

>x shiny amphorae
I only understood you as far as wanting to examine the shiny amphora.

>x shiny amphora
Carved inside is the number Γ.

>x non shining amphora
You can't see any such thing.

>x amphorae
You notice one amphora shine more than the others

>l
Secret Garden
You are in the Secret Garden. You can see red, purple, yellow and white flowers planted in some flowerbeds. In your right you can see some golden amphorae. In the middle of the garden you see an enormous tree with a cavity in the middle

You see a lake. On its shore you see some seashells.

A heavy looking gate that seems to lead to the next room is on the eastern side of the garden, its view mostly obstructed by vines and flowers.

In the garden you see a statue of a beautiful man.

>x tree
(the hollow tree)
You notice it has a cavity in the middle.

>x cavity
Carved inside is the number Δ.

>take cavity
That seems to be a part of the hollow tree.

>eat cavity
That's plainly inedible.

>smell tree
(the hollow tree)
You smell nothing unexpected.

>l
Secret Garden
You are in the Secret Garden. You can see red, purple, yellow and white flowers planted in some flowerbeds. In your right you can see some golden amphorae. In the middle of the garden you see an enormous tree with a cavity in the middle

You see a lake. On its shore you see some seashells.

A heavy looking gate that seems to lead to the next room is on the eastern side of the garden, its view mostly obstructed by vines and flowers.

In the garden you see a statue of a beautiful man.

>x
(the aria)
You see nothing special about the aria.

>x
(the aria)
You see nothing special about the aria.

>i
You are carrying:
  an aria

>l
Secret Garden
You are in the Secret Garden. You can see red, purple, yellow and white flowers planted in some flowerbeds. In your right you can see some golden amphorae. In the middle of the garden you see an enormous tree with a cavity in the middle

You see a lake. On its shore you see some seashells.

A heavy looking gate that seems to lead to the next room is on the eastern side of the garden, its view mostly obstructed by vines and flowers.

In the garden you see a statue of a beautiful man.

>x lake
It's a beautiful lake full of colourfull waterlilies.

>take waterlillies
You can't see any such thing.

>x waterlille
You can't see any such thing.

>x seashells
You find a big conch shell.

>take big conch shell
That's fixed in place.

>x big conch shell
Its cavity is very big. You can faintly see the number Β carved in it.

>l
Secret Garden
You are in the Secret Garden. You can see red, purple, yellow and white flowers planted in some flowerbeds. In your right you can see some golden amphorae. In the middle of the garden you see an enormous tree with a cavity in the middle

You see a lake. On its shore you see some seashells.

A heavy looking gate that seems to lead to the next room is on the eastern side of the garden, its view mostly obstructed by vines and flowers.

In the garden you see a statue of a beautiful man.

>d
You can't go down from here.

>u
Throne Room
Home to the King of Paphos, Cinyras.

You can see Cinyras here.

>d
Secret Garden
You are in the Secret Garden. You can see red, purple, yellow and white flowers planted in some flowerbeds. In your right you can see some golden amphorae. In the middle of the garden you see an enormous tree with a cavity in the middle

You see a lake. On its shore you see some seashells.

A heavy looking gate that seems to lead to the next room is on the eastern side of the garden, its view mostly obstructed by vines and flowers.

In the garden you see a statue of a beautiful man.

>l
Secret Garden
You are in the Secret Garden. You can see red, purple, yellow and white flowers planted in some flowerbeds. In your right you can see some golden amphorae. In the middle of the garden you see an enormous tree with a cavity in the middle

You see a lake. On its shore you see some seashells.

A heavy looking gate that seems to lead to the next room is on the eastern side of the garden, its view mostly obstructed by vines and flowers.

In the garden you see a statue of a beautiful man.

* * *

>d
You can't go down from here.

>d
You can't go down from here.

>l
Secret Garden
You are in the Secret Garden. You can see red, purple, yellow and white flowers planted in some flowerbeds. In your right you can see some golden amphorae. In the middle of the garden you see an enormous tree with a cavity in the middle

You see a lake. On its shore you see some seashells.

A heavy looking gate that seems to lead to the next room is on the eastern side of the garden, its view mostly obstructed by vines and flowers.

In the garden you see a statue of a beautiful man.

>u
Throne Room
Home to the King of Paphos, Cinyras.

You can see Cinyras here.

* * *

>l
Secret Garden
You are in the Secret Garden. You can see red, purple, yellow and white flowers planted in some flowerbeds. In your right you can see some golden amphorae. In the middle of the garden you see an enormous tree with a cavity in the middle

You see a lake. On its shore you see some seashells.

A heavy looking gate that seems to lead to the next room is on the eastern side of the garden, its view mostly obstructed by vines and flowers.

In the garden you see a statue of a beautiful man.

>f
That's not a verb I recognise.

>d
You can't go down from here.

I beg your pardon?

>l
Secret Garden
You are in the Secret Garden. You can see red, purple, yellow and white flowers planted in some flowerbeds. In your right you can see some golden amphorae. In the middle of the garden you see an enormous tree with a cavity in the middle

You see a lake. On its shore you see some seashells.

A heavy looking gate that seems to lead to the next room is on the eastern side of the garden, its view mostly obstructed by vines and flowers.

In the garden you see a statue of a beautiful man.

>take vines
You picked up a vines.

>x statue
You can see a marble sign on the statue's base. His right hand looks like it could be holding something but there's nothing there.

>l
Secret Garden
You are in the Secret Garden. You can see red, purple, yellow and white flowers planted in some flowerbeds. In your right you can see some golden amphorae. In the middle of the garden you see an enormous tree with a cavity in the middle

You see a lake. On its shore you see some seashells.

A heavy looking gate that seems to lead to the next room is on the eastern side of the garden, its view mostly obstructed by vines and flowers.

In the garden you see a statue of a beautiful man.

>x
What do you want to examine?

>x statue
You can see a marble sign on the statue's base. His right hand looks like it could be holding something but there's nothing there.

>x sign
The inscription on it reads: Painful memories of our love surround this place. (A > red, B > purple, C> yellow, D>white)

>l
Secret Garden
You are in the Secret Garden. You can see red, purple, yellow and white flowers planted in some flowerbeds. In your right you can see some golden amphorae. In the middle of the garden you see an enormous tree with a cavity in the middle

You see a lake. On its shore you see some seashells.

A heavy looking gate that seems to lead to the next room is on the eastern side of the garden, its view mostly obstructed by vines and flowers.

In the garden you see a statue of a beautiful man.

>x flowers
You can't use multiple objects with that verb.

>l
Secret Garden
You are in the Secret Garden. You can see red, purple, yellow and white flowers planted in some flowerbeds. In your right you can see some golden amphorae. In the middle of the garden you see an enormous tree with a cavity in the middle

You see a lake. On its shore you see some seashells.

A heavy looking gate that seems to lead to the next room is on the eastern side of the garden, its view mostly obstructed by vines and flowers.

In the garden you see a statue of a beautiful man.

>l
Secret Garden
You are in the Secret Garden. You can see red, purple, yellow and white flowers planted in some flowerbeds. In your right you can see some golden amphorae. In the middle of the garden you see an enormous tree with a cavity in the middle

You see a lake. On its shore you see some seashells.

A heavy looking gate that seems to lead to the next room is on the eastern side of the garden, its view mostly obstructed by vines and flowers.

In the garden you see a statue of a beautiful man.

>x flowerbeds
Which do you mean, the red flowerbed, the purple flowerbed, the yellow flowerbed or the white flowerbed?

>x red flowerbed
You can see some red flowers in this flowerbed.

In the red flowerbed are ten red flowers.

>take red flower
You picked up a red flower.

>ls
That's not a verb I recognise.

>take purple flower
You picked up a purple flower.

>take yellow flower
You picked up a yellow flower.

>take white flower
You picked up a white flower.

>take flowers
red flower: You picked up a red flower.
red flower: You picked up a red flower.
red flower: You picked up a red flower.
red flower: You picked up a red flower.
red flower: You're carrying too many things already.
red flower: You're carrying too many things already.
red flower: You're carrying too many things already.
red flower: You're carrying too many things already.
red flower: You're carrying too many things already.
purple flower: You're carrying too many things already.
purple flower: You're carrying too many things already.
purple flower: You're carrying too many things already.
purple flower: You're carrying too many things already.
purple flower: You're carrying too many things already.
purple flower: You're carrying too many things already.
purple flower: You're carrying too many things already.
purple flower: You're carrying too many things already.
purple flower: You're carrying too many things already.
yellow flower: You're carrying too many things already.
yellow flower: You're carrying too many things already.
yellow flower: You're carrying too many things already.
yellow flower: You're carrying too many things already.
yellow flower: You're carrying too many things already.
yellow flower: You're carrying too many things already.
yellow flower: You're carrying too many things already.
yellow flower: You're carrying too many things already.
yellow flower: You're carrying too many things already.
white flower: You're carrying too many things already.
white flower: You're carrying too many things already.
white flower: You're carrying too many things already.
white flower: You're carrying too many things already.
white flower: You're carrying too many things already.
white flower: You're carrying too many things already.
white flower: You're carrying too many things already.
white flower: You're carrying too many things already.
white flower: You're carrying too many things already.

>i
You are carrying:
  five red flowers
  a white flower
  a yellow flower
  a purple flower
  a vines
  an aria

>eat red flower
That's plainly inedible.

>smell red flower
It smells good.

* * *

>smell white flower
It smells amazing.

>smell yellow flower
It smells good.

>smell purple flower
It smells good.

>smell vines
You smell nothing unexpected.

>smell aria
You smell nothing unexpected.

>x sign
The inscription on it reads: Painful memories of our love surround this place. (A > red, B > purple, C> yellow, D>white)

>put red flower in ha nds
You can't see any such thing.

>put red flower in hands
You can't see any such thing.

>ls
That's not a verb I recognise.

>l
Secret Garden
You are in the Secret Garden. You can see red, purple, yellow and white flowers planted in some flowerbeds. In your right you can see some golden amphorae. In the middle of the garden you see an enormous tree with a cavity in the middle

You see a lake. On its shore you see some seashells.

A heavy looking gate that seems to lead to the next room is on the eastern side of the garden, its view mostly obstructed by vines and flowers.

In the garden you see a statue of a beautiful man.

>x statue
You can see a marble sign on the statue's base. His right hand looks like it could be holding something but there's nothing there.

>put red flower in hand
You place the red flower in the statue's right hand.

* * *

>take hand
That seems to be a part of the statue.

>l
Secret Garden
You are in the Secret Garden. You can see red, purple, yellow and white flowers planted in some flowerbeds. In your right you can see some golden amphorae. In the middle of the garden you see an enormous tree with a cavity in the middle

You see a lake. On its shore you see some seashells.

A heavy looking gate that seems to lead to the next room is on the eastern side of the garden, its view mostly obstructed by vines and flowers.

In the garden you see a statue of a beautiful man.

>x sign
The inscription on it reads: Painful memories of our love surround this place. (A > red, B > purple, C> yellow, D>white)

>put purple flower in shell
You put the purple flower into the conch shell.

>put yellow flower in shiny amphora
You put the yellow flower into the shiny amphora.

>put white flower in treehole
You can't see any such thing.

>put white flower in hole
You can't see any such thing.

>x tree
(the hollow tree)
You notice it has a cavity in the middle.

>put white flower in cavity
You put the white flower into the tree cavity.

You hear the sound of the gate opening

>close gate
It isn't something you can close.

>go in gat
You can't see any such thing.

>go in gate
Divine Cell 4
You see the gods sleeping

You see a lake. On its shore you see some seashells.

A heavy looking gate that seems to lead to the next room is on the eastern side of the garden, its view mostly obstructed by vines and flowers.

You can also see Aphrodite and Hephaestus here.

>l
Divine Cell 4
You see the gods sleeping

You see a lake. On its shore you see some seashells.

A heavy looking gate that seems to lead to the next room is on the eastern side of the garden, its view mostly obstructed by vines and flowers.

You can also see Aphrodite and Hephaestus here.

>l
Divine Cell 4
You see the gods sleeping

You see a lake. On its shore you see some seashells.

A heavy looking gate that seems to lead to the next room is on the eastern side of the garden, its view mostly obstructed by vines and flowers.

You can also see Aphrodite and Hephaestus here.

I beg your pardon?

>l
Divine Cell 4
You see the gods sleeping

You see a lake. On its shore you see some seashells.

A heavy looking gate that seems to lead to the next room is on the eastern side of the garden, its view mostly obstructed by vines and flowers.

You can also see Aphrodite and Hephaestus here.

* * *

I beg your pardon?

>ll
That's not a verb I recognise.

>l
Divine Cell 4
You see the gods sleeping

You see a lake. On its shore you see some seashells.

A heavy looking gate that seems to lead to the next room is on the eastern side of the garden, its view mostly obstructed by vines and flowers.

You can also see Aphrodite and Hephaestus here.

>x aphrodite
You see nothing special about Aphrodite.

>eat aphrodite
She's plainly inedible.

>smell aphrodite
You smell nothing unexpected.

>l
Divine Cell 4
You see the gods sleeping

You see a lake. On its shore you see some seashells.

A heavy looking gate that seems to lead to the next room is on the eastern side of the garden, its view mostly obstructed by vines and flowers.

You can also see Aphrodite and Hephaestus here.

* * *

>x lake
You see nothing special about the lake.

>go to lake
You can't see any such thing.

>go in lake
You can't. All you can see is dirty water.

>drink lake
There's nothing suitable to drink here.

>d
You can't go down from here.

>x statue
You find a marble sign on the statue's base. His right hand looks like it could be holding something but there's nothing there.

>x sign
The inscription on it reads: Painful memories of our love surround this place. (A > red, B > purple, C> yellow, D>white)

>take flowers
red flower: You picked up a red flower.
red flower: You picked up a red flower.
red flower: You picked up a red flower.
red flower: You picked up a red flower.
red flower: You picked up a red flower.
red flower: You picked up a red flower.
red flower: You picked up a red flower.
red flower: You picked up a red flower.
red flower: You picked up a red flower.
red flower: You picked up a red flower.
purple flower: You picked up a purple flower.
purple flower: You picked up a purple flower.
purple flower: You picked up a purple flower.
purple flower: You picked up a purple flower.
purple flower: You picked up a purple flower.
purple flower: You picked up a purple flower.
purple flower: You picked up a purple flower.
purple flower: You picked up a purple flower.
purple flower: You picked up a purple flower.
purple flower: You picked up a purple flower.
yellow flower: You picked up a yellow flower.
yellow flower: You picked up a yellow flower.
yellow flower: You picked up a yellow flower.
yellow flower: You picked up a yellow flower.
yellow flower: You picked up a yellow flower.
yellow flower: You picked up a yellow flower.
yellow flower: You picked up a yellow flower.
yellow flower: You picked up a yellow flower.
yellow flower: You picked up a yellow flower.
yellow flower: You picked up a yellow flower.
white flower: You picked up a white flower.
white flower: You picked up a white flower.
white flower: You picked up a white flower.
white flower: You picked up a white flower.
white flower: You picked up a white flower.
white flower: You picked up a white flower.
white flower: You picked up a white flower.
white flower: You picked up a white flower.
white flower: You picked up a white flower.
white flower: You picked up a white flower.

>i
You are carrying:
  ten white flowers
  ten yellow flowers
  ten purple flowers
  ten red flowers

>x white flower
This is an Bilberry Flower.  In the flower tongue it means "let me go".

* * *

>x yellow flower
This is an Chrysanthemum Flower.  It is said to signify treachery.

>x purple flower
This is an Amaranthos Flower.  It is said to signify unfading love.

>x red flower
This is an Adonis Flower.It is said to signify painful memories.

>enter lake
You swim through the waters.

Divine Cell 4
You see the gods sleeping

You see a lake.

A heavy looking gate that seems to lead to the next room is on the eastern side of the garden, its view obstructed by vines and flowers.

You can also see Aphrodite and Hephaestus here.

>u
Secret Garden
You are in the Secret Garden

You see a lake.

A heavy looking gate that seems to lead to the next room is on the eastern side of the garden, its view obstructed by vines and flowers.

You find yourself before a flowerbed with intense red flowers...

a flowerbed with beautiful purple flowers...

a flowerbed with vibrant yellow flowers...

and a flowerbed with pretty white flowers.

In the garden you see a statue of a beautiful man.

You can also see a container B (empty), a container C (empty) and a container D (empty) here.

>d
You swim through the waters.

Divine Cell 4
You see the gods sleeping

You see a lake.

A heavy looking gate that seems to lead to the next room is on the eastern side of the garden, its view obstructed by vines and flowers.

You can also see Aphrodite and Hephaestus here.

>w
(first opening the puzzle gate)
It isn't something you can open.

>e
You can't go that way.

>u
Secret Garden
You are in the Secret Garden

You see a lake.

A heavy looking gate that seems to lead to the next room is on the eastern side of the garden, its view obstructed by vines and flowers.

You find yourself before a flowerbed with intense red flowers...

a flowerbed with beautiful purple flowers...

a flowerbed with vibrant yellow flowers...

and a flowerbed with pretty white flowers.

In the garden you see a statue of a beautiful man.

You can also see a container B (empty), a container C (empty) and a container D (empty) here.

* * *

>x puzzle gate
The puzzle gate is tightly closed.

>open puzzle gate
It isn't something you can open.

>e
(first opening the puzzle gate)
It isn't something you can open.

>enter puzzle gate
(first opening the puzzle gate)
It isn't something you can open.

>enter statue
That's not something you can enter.

>x statue
The statue depicts a beautiful man. There is a sign on the statue's base. His hands look like they're holding something but there's nothing there. You notice the Greek number A on the statue.

>p flowers
That's not a verb I recognise.

>pick up flowers
red flower: You picked up a red flower.
red flower: You picked up a red flower.
red flower: You picked up a red flower.
red flower: You picked up a red flower.
red flower: You picked up a red flower.
red flower: You picked up a red flower.
red flower: You picked up a red flower.
red flower: You picked up a red flower.
red flower: You picked up a red flower.
red flower: You picked up a red flower.
purple flower: You picked up a purple flower.
purple flower: You picked up a purple flower.
purple flower: You picked up a purple flower.
purple flower: You picked up a purple flower.
purple flower: You picked up a purple flower.
purple flower: You picked up a purple flower.
purple flower: You picked up a purple flower.
purple flower: You picked up a purple flower.
purple flower: You picked up a purple flower.
purple flower: You picked up a purple flower.
yellow flower: You picked up a yellow flower.
yellow flower: You picked up a yellow flower.
yellow flower: You picked up a yellow flower.
yellow flower: You picked up a yellow flower.
yellow flower: You picked up a yellow flower.
yellow flower: You picked up a yellow flower.
yellow flower: You picked up a yellow flower.
yellow flower: You picked up a yellow flower.
yellow flower: You picked up a yellow flower.
yellow flower: You picked up a yellow flower.
white flower: You picked up a  white flower.
white flower: You picked up a  white flower.
white flower: You picked up a  white flower.
white flower: You picked up a  white flower.
white flower: You picked up a  white flower.
white flower: You picked up a  white flower.
white flower: You picked up a  white flower.
white flower: You picked up a  white flower.
white flower: You picked up a  white flower.
white flower: You picked up a  white flower.

>x sign
The sign is made of marble. The inscription on it reads: Painful memories of our love surround this place. (A > red, B > purple, C> yellow, D>white)

>test 1
>--> The following tests are available:
'test me'
'test 2'

>test me
(Testing.)

>[1] put red flower in hands
You place the red flower in the statue's hands.

>[2] put purple flower in b
You put the purple flower into the container B.

>[3] put yellow flower in c
You put the yellow flower into the container C.

>[4] put white flower in d
(the container D)
You put the white flower into the container D.

You hear the sound of the gate opening
>[5] x gate
The puzzle gate is now open.

>[6] take red flower from hands
You picked up a red flower.

You hear the sound of the gate closing.

>[7] go e
(first opening the puzzle gate)
It isn't something you can open.

>put red flower in hands
You place the red flower in the statue's hands.

You hear the sound of the gate opening

>remove purple flower
You aren't wearing the purple flower.

>remove purple flower from container b
You picked up a purple flower.

You hear the sound of the gate closing.

>e
(first opening the puzzle gate)
It isn't something you can open.

>x hands
The statue is holding a hands.

>x hands
The statue is holding a hands.

>x statue
The statue depicts a beautiful man. There is a sign on the statue's base. His hands look like they're holding something but there's nothing there. You notice the Greek number A on the statue.

>put red flower in hands
You place the red flower in the statue's hands.

>x hands
The statue is holding a hands.

* * *

>x room
You can't see any such thing.

>x scenery
You can't see any such thing.

>x
What do you want to examine?

* * *

>i
You are carrying nothing.

>x sundial
The dial is designed with two separate rings encircling its plate, one with sun and one with lunar markings, allowing you to read the time day and night. You also see on the gnomon an inscription engraved and gilded in gold that says: At midday, let Apollo's light cast a shadow, and at midnight, let Artemis' glow guide the way. Only then shall the twins unveil the hidden path.

Judging by the gnomon's shadow and the sun markings, the time is nine o'clock.

>x sun ring
You can't see any such thing.

>take sundial
That's hardly portable.

>smell sundial
It smells neutral.

>x
What do you want to examine?

>l
Temple of the Aulidean Artemis
Inside the Temple of the Aulidean Artemis you can see a sundial, the statue of Artemis and her sacrificial altar.

>x statue
On the base of the statue you can see two locks: one sun-shapped and one moon-shapped.

>x sun lock
The sun lock is empty.

>open sun lock
It isn't something you can open.

>take sun key
Which do you mean, the sun lock or the sun pocket?

>take sun pocket
That seems to be a part of the sundial.

>open sun pocket
It isn't something you can open.

>go in sun pocket
That's not something you can enter.

>turn sun lock
It is fixed in place.

>l
Temple of the Aulidean Artemis
Inside the Temple of the Aulidean Artemis you can see a sundial, the statue of Artemis and her sacrificial altar.

* * *

>x statue
On the base of the statue you can see two locks: one sun-shapped and one moon-shapped.

>smell statue
It smells neutral.

>l
Temple of the Aulidean Artemis
Inside the Temple of the Aulidean Artemis you can see a sundial, the statue of Artemis and her sacrificial altar.

>x altar
The altar of Artemis.

>smell altar
It smells neutral.

>x
What do you want to examine?

>wait until 12
I only understood you as far as wanting to wait.

I beg your pardon?

* * *

>l
Temple of the Aulidean Artemis
Inside the Temple of the Aulidean Artemis you can see a sundial, the statue of Artemis and her sacrificial altar.

>time
That's not a verb I recognise.

>x gnomon
On the gnomon, an inscription engraved and gilded in gold says: At midday, let Apollo's light cast no shadow, and at midnight, let Artemis' glow guide the way. Only then shall the twins unveil the hidden path.

>x sundial
The inscription engraved on the gnomon read: At midday, let Apollo's light cast no shadow, and at midnight, let Artemis' glow guide the way. Only then shall the twins unveil the hidden path.

Judging by the gnomon's shadow and the sun markings, the time is twenty past nine.

>wait for 2 hours and 40 minutes
I only understood you as far as wanting to wait for that.

>wait for 40 minutes
It is now around ten o'clock

>wait for 2 hours
At twelve o'clock  you hear the click of a latch releasing and a sun hatch opening coming from the dial.

It is now around twelve o'clock

I beg your pardon?

>x sun dial
You can't see any such thing.

>l
Temple of the Aulidean Artemis
Inside the Temple of the Aulidean Artemis you can see a sundial, the statue of Artemis and her sacrificial altar.

>x sundial
The inscription engraved on the gnomon read: At midday, let Apollo's light cast no shadow, and at midnight, let Artemis' glow guide the way. Only then shall the twins unveil the hidden path.

Judging by the gnomon's shadow and the sun markings, the time is five past twelve.

>x sun hatch
The sun hatch is open. Inside you can see a sun key.

>take sun key
You picked up a sun key.

>wait for 12 hours
At ten past twelve you hear the sound of the sun hatch closing and the click of a latch locking coming from the dial.

The day passes and a new day is dawing...

At twelve o'clock you hear the click of a latch releasing and a moon hatch opening coming from the dial.

It is now around twelve o'clock

>x moon hatch
The moon hatch is open. Inside you can see a moon key.

At ten past twelve you hear the sound of the moon hatch closing and the click of a latch locking coming from the dial.

>wait for 24 hours
You really don't feel like waiting around that long. Maybe you should sleep instead.

>sleep for 24 hours
I only understood you as far as wanting to sleep.

>sleep
You slept until morning.

>x sundial
The inscription engraved on the gnomon read: At midday, let Apollo's light cast no shadow, and at midnight, let Artemis' glow guide the way. Only then shall the twins unveil the hidden path.

Judging by the gnomon's shadow and the sun markings, the time is nine o'clock.

>wait for 15 hours
You really don't feel like waiting around that long. Maybe you should sleep instead.

>wait for 12 hours
At twelve o'clock  you hear the click of a latch releasing and a sun hatch opening coming from the dial.

At ten past twelve you hear the sound of the sun hatch closing and the click of a latch locking coming from the dial.

It is now around nine o'clock

>wait for 3 hours
It is now around twelve o'clock

I beg your pardon?

>x sundial
The inscription engraved on the gnomon read: At midday, let Apollo's light cast no shadow, and at midnight, let Artemis' glow guide the way. Only then shall the twins unveil the hidden path.

Judging by the gnomon's shadow and the moon markings, the time is five past twelve.

>x sundial
The inscription engraved on the gnomon read: At midday, let Apollo's light cast no shadow, and at midnight, let Artemis' glow guide the way. Only then shall the twins unveil the hidden path.

Judging by the gnomon's shadow and the moon markings, the time is five past twelve.

>wait 4 minutes
It is now around twelve o'clock

>wait 10 minutes
It is now around half past twelve

* * *

>x sundial
The dial is designed with two separate rings encircling its plate, one with sun and one with lunar markings, allowing you to read the time day and night. You also see on the gnomon an inscription engraved and gilded in gold that says: At midday, let Apollo's light cast a shadow, and at midnight, let Artemis' glow guide the way. Only then shall the twins unveil the hidden path.

Judging by the gnomon's shadow and the moon markings, the time is twelve o'clock.

>wait until 7 pm
It is seven o'clock now.

>wait until 11 pm
It is eleven o'clock now.

>wait until 3 am
At ten past twelve you hear the sound of the moon hatch closing and the click of a latch locking coming from the dial.

It is three o'clock now.

>x moon latch
You can't see any such thing.

>x hatch
You can't see any such thing.

>x moon hatch
The moon hatch is closed.

>wait until midday
It is twelve o'clock now.

>scenes
Scene 'Entire Game' playing (for -357 mins now)
Scene 'Day' playing (for -357 mins now)
(Scene monitoring now switched on. Type "scenes off" to switch it off again.)

>x sun latch
You can't see any such thing.

>x sun pocket
The sun hatch is closed.

* * *

>x sundial
The dial is designed with two separate rings encircling its plate, one with sun and one with lunar markings, allowing you to read the time day and night. You also see on the gnomon an inscription engraved and gilded in gold that says: At midday, let Apollo's light cast a shadow, and at midnight, let Artemis' glow guide the way. Only then shall the twins unveil the hidden path.

Judging by the gnomon's shadow and the moon markings, the time is twelve o'clock.

>x statue
On the base of the statue you can see two locks: one sun-shapped and one moon-shapped.

>x altar
The altar of Artemis.

>x sundial
The words carved on the gnomon read: At midday, let Apollo's light cast no shadow, and at midnight, let Artemis" glow guide the way. Only then shall the twins unveil the hidden path.

Judging by the gnomon's shadow and the sun markings, the time is nine o'clock.

>wait until middayu
I only understood you as far as wanting to wait.

>wait until midday
It is twelve o'clock now.

At twelve o'clock you hear the sound of a hatch opening on the dial.

>x sundial opening
I only understood you as far as wanting to examine the sundial.

>x sun pocket
The sun hatch is open. Inside you can see a sun key.

>take sun key
You picked up a sun key.

>w until midnight
I only understood you as far as wanting to (go) west.

>wait until midnight
At ten past twelve you hear the sound of the sun hatch closing.

It is twelve o'clock now.

At twelve o'clock you hear the sound of a flap opening on the dial.

>take moon key
You picked up a moon key.

>x statue
On the base of the statue you can see two locks: one sun-shapped and one moon-shapped.

>put moon key in moon lock
You put the moon key in the moon-shapped lock.

You put the moon key into the moon lock.

>put sun key in sun lock
You put the sun key in the sun-shapped lock.

You put the sun key into the sun lock.

You hear the sound of a locking mechanism unlocking.

>x statue
The statue feels wobbly. Maybe you could try pushing it...

>push statue
You push the statue away and you reveal some stairs leading under the temple.

>d
You take the stairs that lead under the temple.

Divine Cell of Artemis & Apollo
You can see a Goddess Artemis and a God Apollo here.

* * *

>x temple
You can't see any such thing.

>x sundial
The dial is designed with two separate rings encircling its plate, one for sun and one for lunar engravings, allowing you to read the time day and night. You also see on the gnomon an inscription engraved and gilded in gold that says: At midday, let Apollo's light cast no shadow, and at midnight, let Artemis" glow guide the way. Only then shall the twins unveil the hidden path.

Judging by the gnomon's shadow and the sun markings, the time is nine o'clock.

>t
That's not a verb I recognise.

>timer
That's not a verb I recognise.

>time
That's not a verb I recognise.

>what time is it
That's not a verb I recognise.

>i
You are carrying nothing.

>l
Temple of the Aulidean Artemis
You step into the sacred temple of Aulidean Artemis. The temple is empty and abandoned by the priestesses, following Kronos' seizure of power, as expected, unfortunately.

As you pass through the pronaos, your eyes are drawn to the sunlight cascading down from the open ceiling, illuminating an imposing sundial made of pearly white marble that stands at the center of the chamber. The sun's rays cross paths with the dial's gnomon, casting a shadow that marks the hour.

Entering the naos, the most divine part of the temple, you find yourself in the presence of the graceful golden statue of Artemis. Your sister stands tall and proud, her form aglow with a divine radiance that speaks of her unyielding strength and purity. In her left hand, she holds the antlers of a noble deer, symbolizing her dominion over the wild, while her right hand grips her bow, ever ready to protect those who dwell under her watchful eye. A quiver, filled with finely crafted arrows, rests upon her back, the tools of the huntress who lets no prey escape.

Directly in front of her statue is the altar of Artemis, a place where mortals would lay their offerings not long ago, hoping to earn her favor.

>l
Temple of the Aulidean Artemis
You step into the sacred temple of Aulidean Artemis. The temple is empty and abandoned by the priestesses, following Kronos' seizure of power, as expected, unfortunately.

As you pass through the pronaos, your eyes are drawn to the sunlight cascading down from the open ceiling, illuminating an imposing sundial made of pearly white marble that stands at the center of the chamber. The sun's rays cross paths with the dial's gnomon, casting a shadow that marks the hour.

Entering the naos, the most divine part of the temple, you find yourself in the presence of the graceful golden statue of Artemis. Your sister stands tall and proud, her form aglow with a divine radiance that speaks of her unyielding strength and purity. In her left hand, she holds the antlers of a noble deer, symbolizing her dominion over the wild, while her right hand grips her bow, ever ready to protect those who dwell under her watchful eye. A quiver, filled with finely crafted arrows, rests upon her back, the tools of the huntress who lets no prey escape.

Directly in front of her statue is the altar of Artemis, a place where mortals would lay their offerings not long ago, hoping to earn her favor.

>x statue
On the base of the statue you can see two locks: one sun-shapped and one moon-shapped.

>x gnomon
On the gnomon, an inscription engraved and gilded in gold says: At midday, let Apollo's light cast no shadow, and at midnight, let Artemis" glow guide the way. Only then shall the twins unveil the hidden path.

>x sundial
The inscription engraved on the gnomon read: At midday, let Apollo's light cast no shadow, and at midnight, let Artemis" glow guide the way. Only then shall the twins unveil the hidden path.

Judging by the gnomon's shadow and the sun markings, the time is quarter past nine.

>x altar
The altar of Artemis.

>take altar
That's hardly portable.

>take sundial
That's hardly portable.

>take gnomon
That seems to be a part of the sundial.

>wait until 1
At twelve o'clock  you hear the click of a latch releasing and a sun hatch opening coming from the dial.

At ten past twelve you hear the sound of the sun hatch closing and the click of a latch locking coming from the dial.

At twelve o'clock you hear the click of a latch releasing and a moon hatch opening coming from the dial.

At ten past twelve you hear the sound of the moon hatch closing and the click of a latch locking coming from the dial.

It is one o'clock now.

>wait until 12
twelve o'clock passed already. Maybe try again tomorrow.

>wait until midnight
twelve o'clock passed already. Maybe try again tomorrow.

>wait until 24
I only understood you as far as wanting to wait.

>wait until 12
twelve o'clock passed already. Maybe try again tomorrow.

>wait
Time passes.
Would you maybe prefer waiting until a certain time?

>wait until 11
eleven o'clock passed already. Maybe try again tomorrow.

>wait until tomorrow
I only understood you as far as wanting to wait.

>wait tomorrow
I only understood you as far as wanting to wait.

>wait 1 day
I only understood you as far as wanting to wait.

>wait 1 minute
I only understood you as far as wanting to wait.

* * *

>x trapdoor
You can't see such thing.

>open trapdoor
You can't see such thing.

>move table
You put all your strength into pushing the table off the carpet- and you manage it!

* * *

>move carpet
You pulled the carpet. 

By pulling the carpet out of the way you revealed a trapdoor.

>move carpet
You put the carpet back in it's place.

>open trapdoor
It seems to be locked.

>showme trapdoor
trapdoor - locked door
location: in Prytaneion
unlit, inedible, fixed in place, scenery; closed, openable, lockable, locked; singular-named, improper-named; interactable
description: none
initial appearance: none
smell: neutral
leading-through destination: <routine 241648>
printed name: "trapdoor"
printed plural name: "doors"
indefinite article: none
list grouping key: none

>showme table
(the pine table)
pine table - supporter
    empty scroll
    wax tablet
    papyrus scroll
    parchment scroll
location: on the floor in Prytaneion
unlit, inedible, fixed in place, scenery; transparent; singular-named, improper-named; pushed
description: "A large, pine table, likely reserved for the official dinners and gatherings of the prytaneis."
initial appearance: none
smell: neutral
carrying capacity: 100
printed name: "pine table"
printed plural name: "supporters"
indefinite article: none
list grouping key: none

>x supporte
You can't see any such thing.

>x supporter
Which supporter do you mean? Please specify.

>i
You are carrying nothing.

>light 4th torch
You picked up the portable torch.

You lighted the fourth torch using the portable torch.

>i
You are carrying:
  a portable torch

>put out 6th torch
You picked up the snuffer.

The sixth torch is already unlit.

>i
You are carrying:
  a snuffer
  a portable torch

>x
What do you want to examine?

>snuffer
A flame snuffer, to snuff the flames.

>x hearth
According to Aeschines, "the hearth of the Prytaneum is regarded as the common hearth of the state."

* * *

>l]
That's not a verb I recognise.

>l
Temple of the Aulidean Artemis
 You step into the sacred Temple of Aulidean Artemis, where the scent of incense and ancient prayers is still fresh, despite the absence of the priestesses. As you pass through the pronaos, your eyes are drawn to the sunlight cascading down from the open ceiling, illuminating an imposing sundial that stands ar the center of the chamber. The sun's rays trace their path across the dial, a silent testament to the passing hours in this eternal sanctuary.

Entering the naos, the very heart of the temple, you find yourself in the presence of the magnificent golden statue of Artemis. Your sister stands tall and proud, her form aglow with a divine radiance that speaks of her unyielding strength and purity. In her left hand, she holds the antlers of a noble deer, symbolizing her dominion over the wild, while her right hand grips her bow, ever ready to protect those who dwell under her watchful eye. A quiver, filled with finely crafted arrows, rests upon her back, the tools of the huntress who lets no prey escape.

At her feet, the altar of Artemis beckons, a place where mortals have laid their offerings, hoping to earn her favor.

>e
You can't go that way.

* * *

>w
You can't go that way.

>a
That's not a verb I recognise.

>s
You can't go that way.

>d
You can't go that way.

>l
Temple of the Aulidean Artemis
 You step into the sacred Temple of Aulidean Artemis, where the scent of incense and ancient prayers is still fresh, despite the absence of the priestesses. As you pass through the pronaos, your eyes are drawn to the sunlight cascading down from the open ceiling, illuminating an imposing sundial that stands ar the center of the chamber. The sun's rays trace their path across the dial, a silent testament to the passing hours in this eternal sanctuary.

Entering the naos, the very heart of the temple, you find yourself in the presence of the magnificent golden statue of Artemis. Your sister stands tall and proud, her form aglow with a divine radiance that speaks of her unyielding strength and purity. In her left hand, she holds the antlers of a noble deer, symbolizing her dominion over the wild, while her right hand grips her bow, ever ready to protect those who dwell under her watchful eye. A quiver, filled with finely crafted arrows, rests upon her back, the tools of the huntress who lets no prey escape.

At her feet, the altar of Artemis beckons, a place where mortals have laid their offerings, hoping to earn her favor.

>take altar
That's hardly portable.

* * *

>speak with altar
(to yourself)
There is no reply.

>showme altar
(the goddess altar)
goddess altar - supporter
location: in the Temple of the Aulidean Artemis
unlit, inedible, fixed in place, scenery; transparent; singular-named, improper-named
description: "The altar of Artemis."
initial appearance: none
carrying capacity: 100
printed name: "goddess altar"
printed plural name: "supporters"
indefinite article: none
list grouping key: none

* * *

>light 1st torch
You picked up the portable torch.

You lighted the first torch using the portable torch.

>put wax tablet close to the fire
The warmth of the hearth made the wax melt. It revealed some engraved writing under it.

>x wax tablet
The writing reads: Light the tenth, eleventh and thirteenth torches.

* * *

>light 1st torch
You picked up the portable torch.

You lighted the first torch using the portable torch.

>x torch 1
You can't see any such thing.

>i
You are carrying:
  a portable torch

* * *

>light first torch
You picked up the portable torch.
You picked up a portable torch.

You lighted the first torch using the portable torch.

>i
You are carrying nothing.

>actions
Actions listing on.

>light 2nd torch
[burning the second torch]
[(1) taking the portable torch]
That isn't available.
[(1) taking the portable torch - failed the basic accessibility rule]

You lighted the second torch using the portable torch.
[burning the second torch - ended without result]

>x portable torch
[examining 1 portable torch]
You see nothing special about 1 portable torch.

[examining 1 portable torch - succeeded]

>take portable torch
[taking 1 portable torch]
You picked up 1 portable torch.
[taking 1 portable torch - succeeded]

>light 3rd torch
[burning the third torch]
[(1) taking the portable torch]
That isn't available.
[(1) taking the portable torch - failed the basic accessibility rule]

You lighted the third torch using the portable torch.
[burning the third torch - ended without result]

* * *

>light first torch
You picked up the portable torch.
You picked up a portable torch.

You lighted the first torch using the portable torch.

>light second torch
You lighted the second torch using the portable torch.

>actions
Actions listing on.

>light second torch
[burning the second torch]
The second torch is already lit.
[burning the second torch - failed]

>i
[taking inventory]
You are carrying:
  a portable torch

[taking inventory - succeeded]

>put out the first torch
[putting off something the first torch]
[(1) taking the snuffer]
You picked up the snuffer.
[(1) taking the snuffer - succeeded]

You put off the first torch with the flame snuffer.
[putting off something the first torch - ended without result]

>put off the first torch
I didn't understand that sentence.

* * *

>light first torch
You picked up the portable torch.
You picked up a portable torch.

You lighted the first torch using the portable torch.

>x first torch
You see nothing special about the first torch.

>showme first torch
first torch - first torch
location: in Prytaneion
lit, inedible, portable; singular-named, improper-named
description: none
initial appearance: none
printed name: "first torch"
printed plural name: "first torches"
indefinite article: none
list grouping key: none

* * *

>light the first torch
This dangerous act would achieve little.

>switch on the first torch
You lighted first torch.

You switch the first torch on.

* * *

>look
Temple of the Aulidean Artemis
Inside the Temple of the Aulidean Artemis you can see a sundial, the statue of Artemis and her sacrificial altar.

>examine
What do you want to examine?

>put
What do you want to put on?

>look
Temple of the Aulidean Artemis
Inside the Temple of the Aulidean Artemis you can see a sundial, the statue of Artemis and her sacrificial altar.

>take
What do you want to take?

>sundial
That's hardly portable.

>put
What do you want to put on?

>sundial
(first taking the sundial)
That's hardly portable.

>examine
What do you want to examine?

>sundial
The dial is designed with two separate rings encircling its plate, one with sun and one with lunar engravings, allowing you to read the time day and night. You also see on the gnomon an inscription engraved and gilded in gold that says: At midday, let Apollo's light cast no shadow, and at midnight, let Artemis" glow guide the way. Only then shall the twins unveil the hidden path.

Judging by the gnomon's shadow and the sun markings, the time is five past nine.

>look
Temple of the Aulidean Artemis
Inside the Temple of the Aulidean Artemis you can see a sundial, the statue of Artemis and her sacrificial altar.

>put
What do you want to put on?

>rings
You can't see any such thing.

>two rings
That's not a verb I recognise.

>sundial
That's not a verb I recognise.

>wait
Time passes.
Would you maybe prefer waiting until a certain time?

>five past nine
That's not a verb I recognise.

* * *

>look
Temple of the Aulidean Artemis
Inside the Temple of the Aulidean Artemis you can see a sundial, the statue of Artemis and her sacrificial altar.

>examine sundial
The dial is designed with two separate rings encircling its plate, one with sun and one with lunar markings, allowing you to read the time day and night. You also see on the gnomon an inscription engraved and gilded in gold that says: At midday, let Apollo's light cast a shadow, and at midnight, let Artemis' glow guide the way. Only then shall the twins unveil the hidden path.

Judging by the gnomon's shadow and the sun markings, the time is nine o'clock.

>examine arrows
Artemis' arrows. It is part of Artemis' statue.

>examine statue
On the base of the statue you can see two locks: one sun-shapped and one moon-shapped.

>examine antlers
You can't see any such thing.

>examine deer
A deer, one of Artemis' symbols. It is part of Artemis' statue.

>examine sunlight
You can't see any such thing.

>examine sundial
The inscription engraved on the gnomon read: At midday, let Apollo's light cast no shadow, and at midnight, let Artemis' glow guide the way. Only then shall the twins unveil the hidden path.

Judging by the gnomon's shadow and the sun markings, the time is five past nine.

>i
You are carrying nothing.

>take arrows
That's hardly portable.

>take deer
That's hardly portable.

>take sundial
That's hardly portable.

>eat deer
That's plainly inedible.

>eat arrow
You can't see any such thing.

>eat arrows
That's plainly inedible.

>eat sundial
That's plainly inedible.

>examine myself
As good-looking as ever.

>eat myself
You're plainly inedible.

>take myself
You are always self-possessed.

>put myself
What do you want to put yourself in?

>inside the deer
I only understood you as far as wanting to put yourself in inside.

>examine sundial
The inscription engraved on the gnomon read: At midday, let Apollo's light cast no shadow, and at midnight, let Artemis' glow guide the way. Only then shall the twins unveil the hidden path.

Judging by the gnomon's shadow and the sun markings, the time is quarter past nine.

>sleep for two and a half hours
I only understood you as far as wanting to sleep.

>wait until midnight
At twelve o'clock  you hear the click of a latch releasing and a sun hatch opening coming from the dial.

At ten past twelve you hear the sound of the sun hatch closing and the click of a latch locking coming from the dial.

It is twelve o'clock now.

At twelve o'clock you hear the click of a latch releasing and a moon hatch opening coming from the dial.

>examine moon hatch
The moon hatch is open. Inside you can see a moon key.

>take moon key
You picked up a moon key.

>wait midday
I only understood you as far as wanting to wait.

>wait until midday
twelve o'clock passed already. Maybe try again tomorrow.

* * *

>look
Temple of the Aulidean Artemis
Inside the Temple of the Aulidean Artemis you can see a sundial, the statue of Artemis and her sacrificial altar.

>look near the sundial
You can't see any such thing.

>look the sundial
You notice it has both sundial and moondial marks, so you can tell the time both with the help of the sun and the moon. You also see some words carved on its gnomon: At midday, let Apollo's light cast no shadow, and at midnight, let Artemis" glow guide the way. Only then shall the twins unveil the hidden path.

Judging by the gnomon's shadow and the sun markings, the time is nine o'clock.

>look the statue of artemis sacrificial altar
I only understood you as far as wanting to look the statue of artemis.

>yes'
That's not a verb I recognise.

>look it
The words carved on the gnomon read: At midday, let Apollo's light cast no shadow, and at midnight, let Artemis" glow guide the way. Only then shall the twins unveil the hidden path.

Judging by the gnomon's shadow and the sun markings, the time is nine o'clock.

>look the sacrificial altar
The altar of Artemis.

>look the statue of Artemis
On the base of the statue you can see two locks: one sun-shapped and one moon-shapped.

>go to the locks
You can't see any such thing.

>examine the one sun shaped
You can't see any such thing.

>examine the locks
You can't see any such thing.

>examine moon shaped lock
The moon lock is empty.

>examine the other lock
(the sun lock)
The sun lock is empty.

>wait until midday
It is twelve o'clock now.

At twelve o'clock you hear the sound of a hatch opening on the dial.

>examine the sunpocket
You can't see any such thing.

>examine the sun pocket
The sun hatch is open. Inside you can see a sun key.

>grab the key
That's not a verb I recognise.

>take the key
You picked up a sun key.

>use the key to unlock the sun lock
That's not a verb I recognise.

* * *

I beg your pardon?

>fuck you
That's not a verb I recognise.

>thats a lie
That's not a verb I recognise.

* * *

>look box
In Magic Box is a Hercule's Club.

>take club
Taken.

>examine club
You see nothing special about the Hercule's Club.

>examine the Hercule's Club
You see nothing special about the Hercule's Club.

>examine Hercule's Club
You see nothing special about the Hercule's Club.

* * *

>look hera
Hera, draped in a deep purple robe adorned with gold embroidery, her dark hair styled elegantly, feels a mix of contentment and acceptance, her usual sternness softened in celebration.

* * *

>look in box
In Magic Box is a Hercule's Club.

>take it
That's fixed in place.

>take the club
Taken.

>inventory
You are carrying:
  a Hercule's Club

* * *

>look torches
The first torch is unlit.

>examine the torches
The first torch is unlit.

>x torches
The first torch is unlit.

* * *

>move table
You put all your strength into pushing the table off the carpet- and you manage it!

>move carpet
You can't pull the carpet if there are things on top of it.

>move chairs
You push the chairs off the carpet.

>open trapdoor
You can't see such thing.

>test fire
(Testing.)

>[1] light second torch
You picked up the portable torch.

You lighted the second torch using the portable torch.

>[2] light third torch
You lighted the third torch using the portable torch.

>[3] light sixth torch
You lighted the sixth torch using the portable torch.

>[4] light seventh torch
You lighted the seventh torch using the portable torch.

>[5] light eighth torch
You lighted the eighth torch using the portable torch.

>[6] light tenth torch
You lighted the tenth torch using the portable torch.

>[7] light eleventh torch
You lighted the eleventh torch using the portable torch.

>[8] light thirteenth torch
You lighted the thirteenth torch using the portable torch.

>[9] light fourteent torch
You lighted the fourteenth torch using the portable torch.

>[10] light fifteenth torch
You lighted the fifteenth torch using the portable torch.

>[11] light sixteenth torch
You lighted the sixteenth torch using the portable torch.

You hear the sound of something unlocking.

>open trapdoor
You can't see such thing.

>move carpet
You pulled the carpet. 

By pulling the carpet out of the way you revealed a trapdoor.

>open trapdoor
You open the trapdoor.

>showme trapdoor
trapdoor - open door
location: in Prytaneion
unlit, inedible, fixed in place, scenery; open, openable, lockable, unlocked; singular-named, improper-named; interactable
description: none
initial appearance: none
smell: neutral
leading-through destination: <routine 241954>
printed name: "trapdoor"
printed plural name: "doors"
indefinite article: none
list grouping key: none

>actions
Actions listing on.

>open trapdoor
[opening the trapdoor]
That's already open.
[opening the trapdoor - failed the can't open what's already open rule]

>sit on table
[sitting the pine table]
You sit on the pine table.
You simply cannot sit there!

[sitting the pine table - succeeded]

>sit on chair
[sitting the chair]
You sit on the chair.
It feels strurdy and well-made. You get up again.

[sitting the chair - succeeded]

* * *

>n
Gates of Aulis

>s
Northen Gates of Athens

>nw
Stables of Thebes

>w
Stables of Delphi

>n
Foothills of Mount Olympus
Mountain Olympus Hall Description

>s
Stables of Delphi

>nw
Stables of Ephyra

* * *

>s
Northen Gates of Athens

>s
You can't go that way.

>ne
You can't go that way.

>nw
Gates of Thebes

>e
Gates of Aulis

>w
Gates of Thebes

>w
Gates of Delphi

>s
You can't go that way.

>sw
Northen Gates of Athens

>e
Gates of Delphi

>e
Gates of Thebes

>w
Gates of Delphi

>w
You can't go that way.

>nw
Gates of Ephyra

>ne
Foothills of Mount Olympus
Mountain Olympus Hall Description

>s
Gates of Delphi

* * *

>s
Northen Gates of Athens

>w
You can't go that way.

>e
You can't go that way.

>ne
You can't go that way.

>nw
Stables of Thebes

* * *

>oak tree
That's not a verb I recognise.

>look
Mountain Olympus Hall
Mountain Olympus Hall Description

You see your husband here.

You see a box

* * *

>one
That's not a verb I recognise.

>tow
That's not a verb I recognise.

>three
That's not a verb I recognise.

>e
You can't go that way.

>d
You can't go that way.

>u
You can't go that way.

Olympus Hall Celebration Scene ended

* * *

>open box
It seems to be locked.

>Hercule's Club
That's not a verb I recognise.

>inspect Hercule's Club
That's not a verb I recognise.

>inspect
That's not a verb I recognise.

>investigate
That's not a verb I recognise.

>look
Mountain Olympus
Mountain Olympus Description

You see your husband here.

You see a box

I beg your pardon?

>look in box
In Magic Box is a Hercule's Club.

* * *

>open box
It seems to be locked.

>take Hercule's Club.
Taken.

>look Hercule's Club.
You see nothing special about the Hercule's Club.

>seach Hercule's Club.
That's not a verb I recognise.

>search Hercule's Club.
You find nothing of interest.

* * *

>open box
It seems to be locked.

>take key
Taken.

>examine key
The key that unlocks the Magic Box

>open box
It seems to be locked.

>unlock and open box
You can't see any such thing.

>unlock box
(with the Magic Key)
You unlock Magic Box.

>open box
You open Magic Box, revealing a Hercule's Club.

>examine Hercule's Club
You found Hercules'Club! It's heavy, but nothing you can't handle.

>examine key
The key that unlocks the Magic Box

* * *

>open conch shell
It isn't something you can open.

>open hand
It isn't something you can open.

>showme hand
hand - transparent open container
location: part of the statue in the Secret Garden
unlit, inedible, fixed in place; transparent, open, unopenable, unlocked; singular-named, improper-named
description: none
initial appearance: none
carrying capacity: 1
printed name: "hand"
printed plural name: "containers"
indefinite article: none
list grouping key: none

>showme conch shell
conch shell - open container
location: in the Secret Garden
unlit, inedible, fixed in place; opaque, open, unopenable, unlocked; singular-named, improper-named
description: "You examine the conch shell. The poor creature that used to inhabit it must be long gone, surely after having made it to old age. In the iridescent insides you can faintly see a carving: Β."
initial appearance: none
carrying capacity: 1
printed name: "conch shell"
printed plural name: "containers"
indefinite article: none
list grouping key: none

>x containers
(the hand)
You notice the number Α carved on its index finger.
It's not holding anything

* * *

>open trapdoor
It seems to be locked.

>move carpet
You can't pull the carpet if there are things on top of it.

>take torches
What do you want to take those things from?

>take torches
What do you want to take those things from?

>take first torch
That's fixed in place.

* * *

>out
Kadmea
The famous acropolis of Thebes.

You can see the Palace of Kadmea and the Heroon of Kadmos here.

>enter palace
You went into the palace of kadmea
Palace of Kadmea

>out
Kadmea
The famous acropolis of Thebes.

You can see the Palace of Kadmea and the Heroon of Kadmos here.

>enter heroon
You went into the heroon of kadmos
Heroon of Kadmos
You can see a scale, a dragon statue, an altar, a sacrificial plate, some armchairs, a side table with a rock on top, some wall paintings, and a gate with a smaller scale on its right.

>test getweights
(Testing.)

>[1] x dragon statue
A small statue depicting a dragon. It is masterfully sculpted, with meticulous attention evident in every detail. Each scale is rendered with such precision that they appear almost lifelike, giving the dragon a sense of realism. 

The statue's mouth is closed.

>[2] put rock on dragon head
(first taking the rock)
You picked up a rock.

You put the rock on the dragon head.

You hear the sound of stone grinding against stone. The dragon statue's mouth opened.

>[3] x dragon statue
A small statue depicting a dragon. It is masterfully sculpted, with meticulous attention evident in every detail. Each scale is rendered with such precision that they appear almost lifelike, giving the dragon a sense of realism. 

 You see 6 tooth inside the statue's mouth.

>[4] take 6 dragon teeth
dragon tooth: You picked up a dragon tooth.
dragon tooth: You picked up a dragon tooth.
dragon tooth: You picked up a dragon tooth.
dragon tooth: You picked up a dragon tooth.
dragon tooth: You picked up a dragon tooth.
dragon tooth: You picked up a dragon tooth.

>[5] put 6 dragon teeth in the plate
dragon tooth: Done.
dragon tooth: Done.
dragon tooth: Done.
dragon tooth: Done.
dragon tooth: Done.
dragon tooth: Done.

A hole opens at the base of the sacrificial plate, funneling the dragon teeth into the altar. As they settle, a hidden compartment at the bottom of the altar quietly slides open, revealing six variously shaped bronze weights

>test dragongate
(Testing.)

>[1] take weights
owl weight: You picked up an owl weight.
shield weight: You picked up a shield weight.
spear weight: You picked up a spear weight.
snake weight: You picked up a snake weight.
sword weight: You picked up a sword weight.
horse weight: You picked up a horse weight.

>[2] put owl weight on first pan
You put the owl weight on the first pan.

>[3] put snake weight on second pan
You put the snake weight on the second pan.

>[4] put sword weight on third pan
You put the sword weight on the third pan.

>[5] put shield weight on 4th pan
You put the shield weight on the fourth pan.

>[6] put spear weight on 5th pan
You put the spear weight on the fifth pan.

>[7] put horse on 6th pan
You put the horse weight on the sixth pan.

You hear the sound of the gate mechanism unlocking

>enter gate
(first opening the dragon gate)

Divine Cell 1

>enter gate
Heroon of Kadmos
You can see a scale, a dragon statue with a rock on its head, an altar, a sacrificial plate, some armchairs, a side table, some wall paintings, and a gate with a smaller scale on its right.

>x scale
The small scale has 6 pans. It is connected to a metal rod, which appears to serve as a locking mechanism for the gate.

>x large scal
You can't see any such thing.

>x large scale
The small scale has 6 pans. It is connected to a metal rod, which appears to serve as a locking mechanism for the gate.

>l
Heroon of Kadmos
You can see a scale, a dragon statue with a rock on its head, an altar, a sacrificial plate, some armchairs, a side table, some wall paintings, and a gate with a smaller scale on its right.

>sit on armchairs
You sit on the armchair. It's so soft! 
That was a refreshing break. You get up again.

>sit on
(the dragon gate)
You simply cannot sit there!

>sit on armchair
You sit on the armchair. It's so fluffy!

That was a refreshing break. You get up again.

>sit on an armchair
You sit on the armchair. It's so soft! 
That was a refreshing break. You get up again.

>sit on nothing
You can't see any such thing.

>enter gate
Divine Cell 1

>enter gate
Heroon of Kadmos
You can see a scale, a dragon statue with a rock on its head, an altar, a sacrificial plate, some armchairs, a side table, some wall paintings, and a gate with a smaller scale on its right.

>sit on armchairs
You sit on the armchair. It's so fluffy!

That was a refreshing break. You get up again.

>x armchairs
The armchairs are made of fine red silk. They look very soft.

>x armchair
The armchairs are made of fine red silk. They look very soft.

>give nectar to armchair
You can't see any such thing.

>x armchair
The armchairs are made of fine red silk. They look very soft.

>i
You are carrying nothing.

>get out
Kadmea
The famous acropolis of Thebes.

You can see the Palace of Kadmea and the Heroon of Kadmos here.

>d
Agora of Thebes
You can see Kadmea, the acropolis of Thebes, perched up on the hill in the center of the Agora. 

To the south are the city gates

>s
Gates of Thebes
To the north you can see the city of Thebes. 

From here you can travel to: 
→ Athens
→ Aulis
→ Delphi
→ Ephyra
→ Mount Olympus

>n
Agora of Thebes
You can see Kadmea, the acropolis of Thebes, perched up on the hill in the center of the Agora. 

To the south are the city gates

>e
You can't go that way.

* * *

>w
You can't go that way.

>d
You can't go that way.

>u
Kadmea
The famous acropolis of Thebes.

You can see the Palace of Kadmea and the Heroon of Kadmos here.

>d
Agora of Thebes
You can see Kadmea, the acropolis of Thebes, perched up on the hill in the center of the Agora. 

To the south are the city gates

* * *

>s
Gates of Thebes
To the north you can see the city of Thebes. 

From here you can travel to: 
→ Athens
→ Aulis
→ Delphi
→ Ephyra
→ Mount Olympus

>actions
Actions listing on.

* * *

>s
[going south]
You can't go that way.
[going south - failed the can't go that way rule]

>n
[going north]

Agora of Thebes
You can see Kadmea, the acropolis of Thebes, perched up on the hill in the center of the Agora. 

To the south are the city gates

[going north - succeeded]

>s
[going south]

Gates of Thebes
To the north you can see the city of Thebes. 

From here you can travel to: 
→ Athens
→ Aulis
→ Delphi
→ Ephyra
→ Mount Olympus

[going south - succeeded]

>n
[going north]

Agora of Thebes
You can see Kadmea, the acropolis of Thebes, perched up on the hill in the center of the Agora. 

To the south are the city gates

[going north - succeeded]

>u
[going up]

Kadmea
The famous acropolis of Thebes.

You can see the Palace of Kadmea and the Heroon of Kadmos here.

[going up - succeeded]

>sit down
I didn't understand that sentence.

>sit on
What do you want to sit on?

>sit on kadmea
[sitting the palace of kadmea]
You simply cannot sit there!
[sitting the palace of kadmea - failed the check sitting]

* * *

>out
Kadmea
The famous acropolis of Thebes.

You can see the Palace of Kadmea and the Heroon of Kadmos here.

>go in palace
You went into the palace of kadmos
Palace of Kadmos
You can see a scale, a dragon statue, an altar, a sacrificial plate, some wall paintings, and a gate with a smaller on its right.

You can see a dvgate, a rock, a walls, dragon statue, a Kadmea altar (on which is a sacrificial plate (empty)), a pan1, a pan2, a pan3, a pan4, a pan5, a pan6 and a scale here.

>l
Palace of Kadmos
You can see a scale, a dragon statue, an altar, a sacrificial plate, some wall paintings, and a gate with a smaller on its right.

You can see a dvgate, a rock, a walls, dragon statue, a Kadmea altar (on which is a sacrificial plate (empty)), a pan1, a pan2, a pan3, a pan4, a pan5, a pan6 and a scale here.

* * *

>pick smurf
I didn't understand that sentence.

>take smurf
Taken.

>put smurf in red flowerbed
You plant the smurf into the red flowerbed

* * *

>pick up all red flowers
red flower: You picked up a red flower.
red flower: You picked up a red flower.
red flower: You picked up a red flower.
red flower: You picked up a red flower.
red flower: You picked up a red flower.
red flower: You picked up a red flower.
red flower: You picked up a red flower.
red flower: You picked up a red flower.
red flower: You picked up a red flower.
red flower: You picked up a red flower.

>pick up red flower
You already have that.

* * *

>pick up amaranth
You can't see any such thing.

>pick up amaranths
Taken.

>inventory
You are carrying:
  some Amaranths

* * *

>pick up box
That's fixed in place.

>open box
You open Magic Box, revealing a Hercule's Club.

>look Hercule's Club
You see nothing special about the Hercule's Club.

>search Hercule's Club
You find nothing of interest.

>search
What do you want to search?

>pick up Hercule's Club
Taken.

>search Hercule's Club
You find nothing of interest.

>look Hercule's Club
You see nothing special about the Hercule's Club.

>inventory
You are carrying:
  a Hercule's Club

* * *

>i
You are carrying:
  a red flower

* * *

>i
You are carrying:
  two red flowers

* * *

>look
Secret Garden
You see many flowers

You can see some red flowers.

You can see some red flowers.

You can see some red flowers.

You can see some red flowers.

You can see some red flowers.

You can see some red flowers.

You can see some red flowers.

You can see some red flowers.

You can see some red flowers.

You can see some red flowers.

You can also see a statue and a sign here.

>i
You are carrying nothing.

* * *

>pick up flowers
red flower: You picked up a red flower.
red flower: You picked up a red flower.
red flower: You picked up a red flower.
red flower: You picked up a red flower.
red flower: You picked up a red flower.
red flower: You picked up a red flower.
red flower: You picked up a red flower.
red flower: You picked up a red flower.
red flower: You picked up a red flower.
red flower: That was the last red flower. There are no more in this garden.
purple flower: You picked up a purple flower.
purple flower: You picked up a purple flower.
purple flower: You picked up a purple flower.
purple flower: You picked up a purple flower.
purple flower: You picked up a purple flower.
purple flower: You picked up a purple flower.
purple flower: You picked up a purple flower.
purple flower: You picked up a purple flower.
purple flower: You picked up a purple flower.
purple flower: That was the last purple flower. There are no more in this garden.
yellow flower: You picked up a yellow flower.
yellow flower: You picked up a yellow flower.
yellow flower: You picked up a yellow flower.
yellow flower: You picked up a yellow flower.
yellow flower: You picked up a yellow flower.
yellow flower: You picked up a yellow flower.
yellow flower: You picked up a yellow flower.
yellow flower: You picked up a yellow flower.
yellow flower: You picked up a yellow flower.
yellow flower: That was the last yellow flower. There are no more in this garden.
white flower: You picked up a white flower.
white flower: You picked up a white flower.
white flower: You picked up a white flower.
white flower: You picked up a white flower.
white flower: You picked up a white flower.
white flower: You picked up a white flower.
white flower: You picked up a white flower.
white flower: You picked up a white flower.
white flower: You picked up a white flower.
white flower: That was the last white flower. There are no more in this garden.

>examine flowers
You see nothing special about 10 red flowers.

>examine flower
You can't see any such thing.

>i
You are carrying:
  10 red flowers

>examine red flowers
You see nothing special about 10 red flowers.

* * *

>i
You are carrying:
  ten white flowers
  ten yellow flowers
  ten purple flowers
  ten red flowers

>put 3 red flowers in hands
red flower: Done.
red flower: There is no more room in the hands.
red flower: There is no more room in the hands.

* * *

>pick up one red flower
You picked up a red flower.

>pu purple flower
That's not a verb I recognise.

>p flower
That's not a verb I recognise.

>t
That's not a verb I recognise.

>take flower
Which do you mean, a red flower or a purple flower?

>t flower
You can't see any such thing.

>take purple flower
You picked up a purple flower.

>i
You are carrying:
  a purple flower
  a red flower

>x purple flowerbed
You can see some purple flowers in this flowerbed

In the purple flowerbed are nine purple flowers.

>x statue
The statue depicts a beautiful man. He's holding a basket. It is empty.

>put red flower in basket
You put the red flower into the basket.

>x basket
In the basket is a red flower.

>x statue
The statue depicts a beautiful man. He's holding a basket. It has red flowers inside.

>take red flower from basket
You picked up a red flower.

>put purple flower in basket
You put the purple flower into the basket.

>x statue
The statue depicts a beautiful man. He's holding a basket. It has purple flowers inside.

* * *

>pick up re flower
You can't see any such thing.

* * *

>pick up red floer
You can't see any such thing.

>take red flower
You picked up a red flower.

>pick up red flower
You picked up a red flower.

>i
You are carrying:
  two red flowers

* * *

>pick up red flower
You picked up a red flower.

>i
You are carrying:
  a red flower

* * *

>pick up red flower
You picked up a red flower.

>inventory
You are carrying:
  Adonis

* * *

>pick up red flower
You picked up a red flower.

>pick up statue
That's fixed in place.

>pick up 3 red flowers
red flower: You picked up a red flower.
red flower: You picked up a red flower.
red flower: You picked up a red flower.

>put red flower in red flowerbed
You plant the red flower into the red flowerbed

* * *

>pick up red flower
You picked up a red flower.

>take red flower
You picked up a red flower.

>take all red flowers
red flower: You picked up a red flower.
red flower: You picked up a red flower.
red flower: You picked up a red flower.
red flower: You picked up a red flower.
red flower: You picked up a red flower.
red flower: You picked up a red flower.
red flower: You picked up a red flower.
red flower: You picked up a red flower.

>i
You are carrying:
  ten red flowers

>pick up red flower
You already have that.

>x red flowerbed
You picked up every red flower.

* * *

>pick up red flowers
Taken.

>examine flowers
You see nothing special about the red flowers.

>handle flowers
That's not a verb I recognise.

>look flowers
You see nothing special about the red flowers.

>search flowers
You find nothing of interest.

* * *

>pick up white flowe
You can't see any such thing.

>pick up white flower
You picked up a white flower.

>x flower
(the white flower)
This is an Bilberry Flower.  It is said to signify treachery.

* * *

>pull big table
You pulled the table

>pull chairs
You pulled the chair

>pull carpet
You pulled the carpet
ole!

* * *

>pull carpet
You can't pull the carpet if there are things on top of it.

>pull chairs
You pulled the chair

>pull table
You put all your strength into pushing the table- and you manage it!

* * *

>pull table
You put all your strength into pushing the table off the carpet- and you manage it!

>pull carpet
You can't pull the carpet if there are things on top of it.

>pull chair
You push the chairs off the carpet.

>pull carpet
You pulled the carpet. 
By pulling the carpet out of the way you revealed a trapdoor.

>pull chair
You push the chairs on the carpet again.

* * *

>pull table
You put all your strength into pushing the table off the carpet- and you manage it!

>pull chairs
You push the chairs off the carpet.

>pull carpet
You pulled the carpet. 

By pulling the carpet out of the way you revealed a trapdoor.

>test fire
(Testing.)

>[1] light second torch
You picked up the portable torch.

You lighted the second torch using the portable torch.

>[2] light third torch
You lighted the third torch using the portable torch.

>[3] light sixth torch
You lighted the sixth torch using the portable torch.

>[4] light seventh torch
You lighted the seventh torch using the portable torch.

>[5] light eighth torch
You lighted the eighth torch using the portable torch.

>[6] light tenth torch
You lighted the tenth torch using the portable torch.

>[7] light eleventh torch
You lighted the eleventh torch using the portable torch.

>[8] light thirteenth torch
You lighted the thirteenth torch using the portable torch.

>[9] light fourteent torch
You lighted the fourteenth torch using the portable torch.

>[10] light fifteenth torch
You lighted the fifteenth torch using the portable torch.

>[11] light sixteenth torch
You lighted the sixteenth torch using the portable torch.

You hear the sound of the trapdoor unlocking.

>enter trapdoor
(first opening the trapdoor)

Divine Cell 5
TODO mmm gods now

>talk to hestia
That's not a verb I recognise.

>talk with hestia
That's not a verb I recognise.

* * *

>push carpet
You can't pull the carpet if there are things on top of it.

>push table
You put all your strength into pushing the table off the carpet- and you manage it!

>push table
You pushed the table on the carpet again.

>push chair
You push the chairs off the carpet.

>push carpet
You can't pull the carpet if there are things on top of it.

I beg your pardon?

>x table
A large, pine table, likely reserved for the official dinners and gatherings of the prytaneis.

>x pine table
A large, pine table, likely reserved for the official dinners and gatherings of the prytaneis.

>x chair
The chairs are a matching set with the table, all crafted of pine.

>push table
You pushed the table off the carpet.

>take carpet
That's called theft! Refer from it in the future.

>pull carpet
You pulled the carpet

By pulling the carpet out of the way you revealed a trapdoor.

* * *

>push the table
You put all your strength into pushing the table off the carpet- and you manage it!

>push the chairs
You push the chairs off the carpet.

>push the carpet
You pulled the carpet. 

By pulling the carpet out of the way you revealed a trapdoor.

>test fire
(Testing.)

>[1] light second torch
You picked up the portable torch.

You lighted the second torch using the portable torch.

>[2] light third torch
You lighted the third torch using the portable torch.

>[3] light sixth torch
You lighted the sixth torch using the portable torch.

>[4] light seventh torch
You lighted the seventh torch using the portable torch.

>[5] light eighth torch
You lighted the eighth torch using the portable torch.

>[6] light tenth torch
You lighted the tenth torch using the portable torch.

>[7] light eleventh torch
You lighted the eleventh torch using the portable torch.

>[8] light thirteenth torch
You lighted the thirteenth torch using the portable torch.

>[9] light fourteent torch
You lighted the fourteenth torch using the portable torch.

>[10] light fifteenth torch
You lighted the fifteenth torch using the portable torch.

>[11] light sixteenth torch
You lighted the sixteenth torch using the portable torch.

You hear the sound of the trapdoor unlocking.

>enter door
You can't see any such thing.

>enter trapdoor
(first opening the trapdoor)

Divine Cell 5
TODO mmm gods now

You can see Maria here.

>talk to hestia
You can't see any such thing.

>showme
Divine Cell 5 - room
    trapdoor - open door
    yourself - woman
        portable torch
    Maria - woman

>talk to maria
...

* * *

>put aria in hand
You place the aria in the statue's right hand.

>x hand
You notice the number Α carved on its index finger.
It's holding an aria.

* * *

>put aria in red flowerbed
You can't burry that here.

>take red flower
You picked up a red flower.

>put flower in red flowerbed
Which do you mean, a red flower, a purple flower, a yellow flower or a white flower?

>put red flower in red flowerbed
You plant the red flower into the red flowerbed

* * *

>put red flower in hand
You place the red flower in the statue's right hand.

>x hand
You notice the number Α carved on its index finger.
It's holding  red flower.

* * *

>put red flower in hands
You place the red flower in the statue's hands.

>x hands
The statue is holding a flower.

>x hands
The statue is holding a flower.

>i
You are carrying nothing.

>take red flower from hands
You picked up a red flower.

>i
You are carrying:
  a red flower

>put red flower in hands
You place the red flower in the statue's hands.

* * *

>read sign
The inscription on it reads: Painful memories of our love surround this place. (A > red, B > purple, C> yellow, D>white)

>read statue
You find a marble sign on the statue's base. His right hand looks like it could be holding something but there's nothing there. You notice the Greek number  Γ on the statue.

>pick up yellow flower
You picked up a yellow flower.

>x flower
(the yellow flower)
This is an Chrysanthemum Flower.  It is said to signify treachery.

* * *

>rotate ring 1
Nothing obvious happens.

>showme ring 1
Ring 1 - ring
location: on the column in the Poseidon's Temple
unlit, inedible, portable; singular-named, proper-named
description: none
initial appearance: none
ring face: blank
printed name: "Ring 1"
printed plural name: "rings"
indefinite article: none
list grouping key: none

>x ring 1
Its face shows blank.

* * *

>s
Agora of Athens

>e
Acropolis

* * *

>s
Agora of Athens

>enter
You must supply a noun.

* * *

>s
Agora of Athens

>enter sea
The nereides agree to take you to the sunken Temple .

Temple of Poseidon
Description of temple of poseidon.

* * *

>s
Agora of Athens

>go s
You must supply a noun.

* * *

>s
Agora of Athens

>n
You can't go that way.

>u
Sounio Beach
Description of Sounio beach. You see some nereides fighting.

You can see some nereides, Aktaia, Erato, Ploto and an angry nereida here.

>enter the sea
The nereides agree to take you to the sunken Temple .

Temple of Poseidon
Description of temple of poseidon.

* * *

>s
Agora of Athens

>rotate ring 1
Nothing obvious happens.

>x ring 1
Its face showsblank.

* * *

>s
Agora of Athens

>rotate ring1
Nothing obvious happens.

>x ring1
On it you can see none.

>showme ring 1
There seems to be no such object anywhere in the model world.

>showme ring1
Ring1 - ring
location: on the column in the Poseidon's Temple
unlit, inedible, portable; singular-named, proper-named
description: none
initial appearance: none
ring face: none
printed name: "Ring1"
printed plural name: "rings"
indefinite article: none
list grouping key: none

* * *

>s
Agora of Athens

>se
Southern Gates of Athens

>n
You can't go that way.

* * *

>nw
Agora of Athens

>sw
Port of Piraeus
TODO: Pireaus Description (where the player can go?)

>sail to cyprus
That noun did not make sense in this context.

>sail to paphos
You can't sail there.

>sail to port of paphos
You can't sail there.

>l
Port of Piraeus
TODO: Pireaus Description (where the player can go?)

>ne
Agora of Athens

>n
Northen Gates of Athens

>sail to aulis
You can't sail there.

>travel to aulis
Gates of Aulis
You travel to Gates of Aulis.

* * *

>s
Agora of Athens

>showme
Sounio Beach - room
    sea - closed door
    yourself - woman
        aria
    nereides - woman
    Aktaia - woman
    Erato - woman
    Ploto - woman
    angry nereida - woman

>i
You are carrying:
  an aria

* * *

>s
Agora of Athens

>take weight1
You can't see any such thing.

>test cad
(Testing.)

>[1] x dragon statue
The statue's mouth is closed.

bazoonga
>[2] put rock on dragon head
(first taking the rock)
You picked up a rock.

You put the rock on the dragon head.

The statue's mouth opened.

bazoonga
>[3] x dragon statue
 You see 6 tooth inside the statue's mouth.

bazoonga
>[4] take 6 dragon teeth
dragon tooth: You picked up a dragon tooth.
dragon tooth: You picked up a dragon tooth.
dragon tooth: You picked up a dragon tooth.
dragon tooth: You picked up a dragon tooth.
dragon tooth: You picked up a dragon tooth.
dragon tooth: You picked up a dragon tooth.

bazoonga
>[5] put 6 dragon teeth in the plate
dragon tooth: Done.
dragon tooth: Done.
dragon tooth: Done.
dragon tooth: Done.
dragon tooth: Done.
dragon tooth: Done.

The dragon teeth are syphoned into the altar and a compartment door opens, exposing 6 weights.

bazoonga

>take weight1
You picked up a weight1.

bazoonga

* * *

>s
Agora of Athens

>x ring 1
You can't see any such thing.

>x Ring 1
You can't see any such thing.

>x ring1
You see nothing special about Ring1.

I beg your pardon?

>showme ring1
Ring1 - ring
location: on the column in the Poseidon's Temple
unlit, inedible, portable; singular-named, proper-named
description: none
initial appearance: none
ring face: none
printed name: "Ring1"
printed plural name: "rings"
indefinite article: none
list grouping key: none

* * *

>s
Agora of Athens

>x ring1
On it you can see none.

>rotate ring
Which do you mean, Ring 2 or Ring 4?

>rotate ring1
Nothing obvious happens.

* * *

>sail to cuprus
That noun did not make sense in this context.

* * *

>save
Ok.

>help
Basic Commands

1. Movement Commands:

   • Go [direction]: Move to another room. Example: "go north", "go in" or "enter", "out".
   • Directions include: north, south, east, west, northeast, northwest, southeast, southwest, up, and down.
   • You can also use the shortcuts n, s, e, w, ne, nw, se, sw, u and d.

2. Interaction Commands:

   • Look: Examine your surroundings. Example: "look", "look around", "l".
   • Examine [object]: Inspect an item in detail. Example: "examine book", "x book".
   • Take [object]: Pick up an item. Example: "take key".
   • Drop [object]: Put down an item. Example: "drop book".
   • Put [object] on/in [object]: Put an item on top or inside another item. Example: "put flower in pot".
   • Open/Close [object]: Open or close something. Example: "open door", "close box".
   • Give [object] to [person]: Give an item to someone. Example: "give book to librarian".

3. Conversation Commands:

   • Talk to [person]: Initiate conversation. Example: "talk to librarian".
   • Ask [person] about [topic]: Ask someone about something specific. Example: "ask librarian about book".
   • Tell [person] about [topic]: Tell someone about a topic. Example: "tell librarian about secret".

4. Miscellaneous Commands:

   • Inventory: See what you're carrying. Example: "inventory", "i".
   • Wait: Pass time. Example: "wait".
   • Save/Restore/Quit: Manage your game. Example: "save", "restore", "quit".

5. Game-Specific Commands:

   • 

You can also combine commands with objects and people, such as "take book and give it to librarian".

* * *

>scenes
Scene 'Entire Game' playing (for 0 mins now)
Scene 'Olympus Hall Celebration Scene' playing (for 0 mins now)
(Scene monitoring now switched on. Type "scenes off" to switch it off again.)

>d
Elysial Fields

>d
Asphodel Meadows
You can see a bridge here.

[Scene 'Hercules in Asphodel Scene' begins]

>i
You are carrying nothing.

* * *

>scenes
Scene 'Entire Game' playing (for 0 mins now)
Scene 'Olympus Hall Celebration Scene' playing (for 0 mins now)
(Scene monitoring now switched on. Type "scenes off" to switch it off again.)

>enter boat
You should pay the ferryman first. One obol is the standard price.

>give obol to charon
You give Obol to Charon.

[Scene 'Charon Ride In Scene' begins]
The ferryman accepts the token and signals you to jump into the boat. With slow and certain movements, he leads the boat down the dangerous stream, into the opening of a natural cave. You arrive at the Underworld.

>[enter]
Elysial Fields
You can see a Charon's boat here.

[Scene 'Charon Ride In Scene' ends]

>l
Elysial Fields
You can see a Charon's boat here.

* * *

>enter boat
You should pay the ferryman first. One obol is the standard price.

>i
You are carrying:
  Obol

>give one obol to charon
You give Obol to Charon.

[Scene 'Charon Ride In Scene' begins]
The ferryman accepts the token and signals you to jump into the boat. With slow and certain movements, he leads the boat down the dangerous stream, into the opening of a natural cave. You arrive at the Underworld.

>[enter]
Elysian Fields
You can see a Charon's boat here.

[Scene 'Charon Ride In Scene' ends]

>l
Elysian Fields
You can see Charon and a Charon's boat here.

>showme
Elysian Fields - room
    Charon - man
        Obol
    Charon's boat - closed door
    yourself - woman

* * *

>scenes
Scene 'Entire Game' playing (for 0 mins now)
Scene 'Olympus Hall Celebration Scene' playing (for 0 mins now)
(Scene monitoring now switched on. Type "scenes off" to switch it off again.)

>give club to heracles
(first taking the Heracles' Club)
You picked up the Club of Heracles.

He smiles at you. "Thank you my dearest."

[Scene 'Olympus Hall Celebration Scene' ends]
[Scene 'Kronos Scene' begins]

>[enter]
Suddenly, an eerie silence fell over the festive night. The singing and dancing ceased, as if an unseen hand had stilled them. For a brief moment, you felt the coldness of the mountain air, a stark contrast to the pleasant breeze that had enveloped you moments before. A sense of foreboding fills you as you become aware that all eyes are turned behind you. You lock eyes with Heracles, both of you sharing a look of worry. With a growing sense of dread, you turned to see what had drawn everyone's attention.

"Oh dear, please, do not let my presence taint your insignificant gathering. Carry on as you were."

The voice was unmistakable, deep and resonant, carrying an ancient power that sent shivers down your spine. It was Kronos. So much time has passed since our triumph in the War of Titans- the Titanomachy. How did he manage to escape Tartaros?

The sight of the Titan, towering and menacing, shrouded in shadows, struck fear into the hearts of all present. You start to feel the ichor in your divine veins turn cold, as if time itself had frozen. The gods, normally so mighty and formidable, stand paralyzed in shock. Nothing moves. In a heartbeat, you break free from the daze and come to your senses. Your next actions have never been more certain. It's now or never.

You grab Heracle's club out of his hands and leap towards Kronos. Then you feel yourself slipping into unconciousness.

[Scene 'Kronos Scene' ends]

>[enter]
Garden of Hesperides

From here you can sail to: 
→ Piraeus
→ Sounio
→ Aulis
→ Paphos

You can see Eternal Chalice of Nectar, Aigle, Arethousa, Erytheia and Hesperie here.

[Scene 'Garden of Hesperides Scene' begins]

>l
Garden of Hesperides
You slowly regain consciousness, greeted by the soft rustling of leaves of a tranquil garden. As your eyes flutter open, you find yourself surrounded by four enchanting numphs. Their expressions are a mix of deep concern and immense relief, as if they've been holding their breath waiting for this moment. You instantly recognise Aigle, Arethousa, Erytheia and Hesperie, the nymphs of the evening known as Hesperides, guardians of the orchard of the Garden of Hesperides.

"Hebe, it's been two weeks!" Arethousa exclaims, her voice a blend of worry and joy. "We were all so anxious for you to wake up."

With gentle hands, the nymphs help you to sit up, their embraces warm and comforting. The familiar scent of the Garden of Hesperides fills your senses, grounding you in the safety of their presence.

Aigle, her expression displaying a hint of urgency, leans in. "You should get moving now that you're awake. There are disturbing rumors that Kronos has imprisoned the gods and is attempting to free his brothers from Tartaros. You're the only goddess we've seen show any signs of activity lately."

Erytheia nods in agreement. "We don't have many details, but the Oracle of Delphi might have the answers you need. It would be wise to seek her counsel."

Hesperie steps forward, holding out something. It is the Eternal Chalice of Nectar, once your symbol of duty as the cupbearer of the gods before the events that led to Ganymedes taking on that role. Her eyes are earnest as she places the chalice in your hands.

"You might need this," Hesperie says softly. "Without nectar or ambrosia, gods can lose their immortality and eternal youth. You know this better than anyone."

The Hesperides embrace you one last time. "Good luck, Hebe!" they all say in unison. "We will be here, supporting you in any way we can." 

You can see Eternal Chalice of Nectar, Aigle, Arethousa, Erytheia and Hesperie here.

[Scene 'Garden of Hesperides Scene' ends]

* * *

>scenes
Scene 'Entire Game' playing (for 0 mins now)
Scene 'Olympus Hall Celebration Scene' playing (for 0 mins now)
(Scene monitoring now switched on. Type "scenes off" to switch it off again.)

>give heracles club
(first taking the Heracles' Club)
You picked up the Club of Heracles.

He smiles at you. "Thank you my dearest."

[Scene 'Olympus Hall Celebration Scene' ends]
[Scene 'Kronos Scene' begins]

>[enter]
Suddenly, an eerie silence fell over the festive night. The singing and dancing ceased, as if an unseen hand had stilled them. For a brief moment, you felt the coldness of the mountain air, a stark contrast to the pleasant breeze that had enveloped you moments before. A sense of foreboding fills you as you become aware that all eyes are turned behind you. You lock eyes with Heracles, both of you sharing a look of worry. With a growing sense of dread, you turned to see what had drawn everyone's attention.

"Oh dear, please, do not let my presence taint your insignificant gathering. Carry on as you were."

The voice was unmistakable, deep and resonant, carrying an ancient power that sent shivers down your spine. It was Kronos. So much time has passed since our triumph in the War of Titans- the Titanomachy. How did he manage to escape Tartaros?

The sight of the Titan, towering and menacing, shrouded in shadows, struck fear into the hearts of all present. You start to feel the ichor in your divine veins turn cold, as if time itself had frozen. The gods, normally so mighty and formidable, stand paralyzed in shock. Nothing moves. In a heartbeat, you break free from the daze and come to your senses. Your next actions have never been more certain. It's now or never.

You grab Heracle's club out of his hands and leap towards Kronos. Then you feel yourself slipping into unconciousness.

[Scene 'Kronos Scene' ends]

>[enter]
[Scene 'Garden of Hesperides Scene' begins]
Garden of Hesperides
You can see Eternal Chalice of Nectar, Aigle, Arethousa, Erytheia and Hesperie here.

Garden of Hesperides
You slowly regain consciousness, greeted by the soft rustling of leaves of a tranquil garden. As your eyes flutter open, you find yourself surrounded by four enchanting numphs. Their expressions are a mix of deep concern and immense relief, as if they've been holding their breath waiting for this moment. You instantly recognise Aigle, Arethousa, Erytheia and Hesperie, the nymphs of the evening known as Hesperides, guardians of the orchard of the Garden of Hesperides.

"Hebe, it's been two weeks!" Arethousa exclaims, her voice a blend of worry and joy. "We were all so anxious for you to wake up."

With gentle hands, the nymphs help you to sit up, their embraces warm and comforting. The familiar scent of the Garden of Hesperides fills your senses, grounding you in the safety of their presence.

Aigle, her expression displaying a hint of urgency, leans in. "You should get moving now that you're awake. There are disturbing rumors that Kronos has imprisoned the gods and is attempting to free his brothers from Tartaros. You're the only goddess we've seen show any signs of activity lately."

Erytheia nods in agreement. "We don't have many details, but the Oracle of Delphi might have the answers you need. It would be wise to seek her counsel."

Hesperie steps forward, holding out something. It is the Eternal Chalice of Nectar, once your symbol of duty as the cupbearer of the gods before the events that led to Ganymedes taking on that role. Her eyes are earnest as she places the chalice in your hands.

"You might need this," Hesperie says softly. "Without nectar or ambrosia, gods can lose their immortality and eternal youth. You know this better than anyone."

The Hesperides embrace you one last time. "Good luck, Hebe!" they all say in unison. "We will be here, supporting you in any way we can." 

You can see Eternal Chalice of Nectar, Aigle, Arethousa, Erytheia and Hesperie here.

* * *

>scenes
Scene 'Entire Game' playing (for 0 mins now)
Scene 'Olympus Hall Celebration Scene' playing (for 0 mins now)
(Scene monitoring now switched on. Type "scenes off" to switch it off again.)

>test getweights
(Testing.)

>[1] x dragon statue
A small statue depicting a dragon. It is masterfully sculpted, with meticulous attention evident in every detail. Each scale is rendered with such precision that they appear almost lifelike, giving the dragon a sense of realism. 

The statue's mouth is closed.

>[2] put rock on dragon head
(first taking the rock)
You picked up a rock.

You put the rock on the dragon head.

You hear the sound of stone grinding against stone. The dragon statue's mouth opened.

>[3] x dragon statue
A small statue depicting a dragon. It is masterfully sculpted, with meticulous attention evident in every detail. Each scale is rendered with such precision that they appear almost lifelike, giving the dragon a sense of realism. 

 You see 6 tooth inside the statue's mouth.

>[4] take 6 dragon teeth
dragon tooth: You picked up a dragon tooth.
dragon tooth: You picked up a dragon tooth.
dragon tooth: You picked up a dragon tooth.
dragon tooth: You picked up a dragon tooth.
dragon tooth: You picked up a dragon tooth.
dragon tooth: You picked up a dragon tooth.

>[5] put 6 dragon teeth in the plate
dragon tooth: Done.
dragon tooth: Done.
dragon tooth: Done.
dragon tooth: Done.
dragon tooth: Done.
dragon tooth: Done.

The dragon teeth are syphoned into the altar and a compartment door opens, exposing 6 weights.

>test dragon gate
I only understood you as far as wanting to test that.

>test dragongate
(Testing.)

>[1] take weights
owl weight: You picked up an owl weight.
shield weight: You picked up a shield weight.
spear weight: You picked up a spear weight.
snake weight: You picked up a snake weight.
sword weight: You picked up a sword weight.
horse weight: You picked up a horse weight.

>[2] put owl weight on first pan
You put the owl weight on the first pan.

>[3] put snake weight on second pan
You put the snake weight on the second pan.

>[4] put sword weight on third pan
You put the sword weight on the third pan.

>[5] put shield weight on 4th pan
You put the shield weight on the fourth pan.

>[6] put spear weight on 5th pan
You put the spear weight on the fifth pan.

>[7] put horse on 6th pan
You put the horse weight on the sixth pan.

You hear the sound of the gate mechanism unlocking

>actions
Actions listing on.

>x gate
[examining the dragon gate]
The gate is now unlocked.
[examining the dragon gate - failed]

>enter gate
[entering the dragon gate]
[(1) going the dragon gate]
(first opening the dragon gate)
[(2) opening the dragon gate - silently]
[(2) opening the dragon gate - silently - succeeded]

Divine Cell 1
[(1) going the dragon gate - succeeded]

[entering the dragon gate - succeeded]

[Scene 'Kadmea Puzzle Scene' ends]

>showme gate
(the dragon gate)
dragon gate - open door
    inscription (part of dragon gate)
location: in Divine Cell 1
unlit, inedible, fixed in place, scenery; open, unopenable, lockable, unlocked; singular-named, improper-named
description: none
initial appearance: none
smell: neutral
leading-through destination: <routine 229834>
printed name: "dragon gate"
printed plural name: "doors"
indefinite article: none
list grouping key: none

>enter gate
[entering the dragon gate]
[(1) going the dragon gate]

Palace of Kadmos
You can see a scale, a dragon statue, an altar, a sacrificial plate, some armchairs, a side table with a rock on top, some wall paintings, and a gate with a smaller scale on its right.

[(1) going the dragon gate - succeeded]

[entering the dragon gate - succeeded]

>l
[looking]
Palace of Kadmos
You can see a scale, a dragon statue, an altar, a sacrificial plate, some armchairs, a side table with a rock on top, some wall paintings, and a gate with a smaller scale on its right.

[looking - succeeded]

* * *

>scenes
Scene 'Entire Game' playing (for 0 mins now)
Scene 'Olympus Hall Celebration Scene' playing (for 0 mins now)
(Scene monitoring now switched on. Type "scenes off" to switch it off again.)

>wait until 4
It is four o'clock now.

>scenes
Scene 'Entire Game' playing (for 1 mins now)
Scene 'Day' playing (for 1 mins now)
(Scene monitoring now switched on. Type "scenes off" to switch it off again.)

>wait until 10 pm
[Scene 'Day' ends]
[Scene 'Night' begins]
It is ten o'clock now.

>l
sounio beach
Description of Sounio beach. You see some nereides fighting. Poseidon's temple is in the sea.

The city of Sounio is on the west.

You can see some nereides, Aktaia, Erato, Ploto and an angry nereida here.

>wait until midnight
[Scene 'Night' ends]
The day passes.
[Scene 'Day' begins]

It is twelve o'clock now.

At twelve o'clock you hear the click of a latch releasing and a moon hatch opening coming from the dial.

>scenes
Scene 'Entire Game' playing (for -539 mins now)
Scene 'Day' playing (for 1 mins now)
Scene 'Night' ended
(Scene monitoring now switched on. Type "scenes off" to switch it off again.)

* * *

>show me hand
(first taking the hand)
That seems to be a part of the statue.

>showme hand
hand - transparent open container
location: part of the statue in the Secret Garden
unlit, inedible, fixed in place; transparent, open, unopenable, unlocked; singular-named, improper-named
description: none
initial appearance: none
carrying capacity: 1
printed name: "hand"
printed plural name: "containers"
indefinite article: none
list grouping key: none

>showme cavity
tree cavity - open container
location: part of the weeping willow in the Secret Garden
unlit, inedible, fixed in place; opaque, open, unopenable, unlocked; singular-named, improper-named
description: none
initial appearance: none
carrying capacity: 1
printed name: "tree cavity"
printed plural name: "containers"
indefinite article: none
list grouping key: none

>containers
That's not a verb I recognise.

>take containers
(the hand)
That seems to be a part of the statue.

* * *

>showme
East of Ephyra - room
    Acheron River - backdrop
    Charon's boat - closed door
    yourself - woman
        Obol
    Charon - man

>give obol to charon
You give Obol to Charon.

The ferryman accepts the token and signals you to jump into the boat. With slow and certain movements, he leads the boat down the dangerous stream, into the opening of a natural cave. You arrive at the Underworld.

* * *

>[enter]
Elysial Fields
You can see a Charon's boat here.

>showme
Elysial Fields - room
    Charon's boat - open door
    yourself - woman

* * *

>showme
East of Ephyra - room
    Acheron River - backdrop
    Charon's boat - closed door
    yourself - woman
        Obol
    Charon - man

>i
You are carrying:
  an aria

>enter sea
The nereides agree to take you to the sunken Temple .

Temple of Poseidon
Description of temple of poseidon.

* * *

>showme
Sounio Beach - room
    sea - closed door
    yourself - woman
        aria
    nereides - woman
    Aktaia - woman
    Erato - woman
    Ploto - woman
    angry nereida - woman

* * *

>i
You are carrying:
  an aria

>drop aria
Dropped.

>i
You are carrying nothing.

>showme
Sounio Beach - room
    aria
    sea - closed door
    yourself - woman
    nereides - woman
    Aktaia - woman
    Erato - woman
    Ploto - woman
    angry nereida - woman

>get aria
You picked up a aria.

>showme
Sounio Beach - room
    sea - closed door
    yourself - woman
        aria
    nereides - woman
    Aktaia - woman
    Erato - woman
    Ploto - woman
    angry nereida - woman

* * *

>showme niche
niche - transparent open container
location: part of dragon statue in Cadmea
unlit, inedible, portable; transparent, open, unopenable, unlocked; singular-named, improper-named
description: none
initial appearance: "niche."
carrying capacity: 100
printed name: "niche"
printed plural name: "containers"
indefinite article: none
list grouping key: none

>look statue
You see nothing special about dragon statue.

* * *

>showme rings
top ring - ring
location: on the column in the Poseidon's Temple
unlit, inedible, portable; singular-named, proper-named
description: none
initial appearance: none
ring face: blank
printed name: "top ring"
printed plural name: "rings"
indefinite article: none
list grouping key: none
second ring - ring
location: on the column in the Poseidon's Temple
unlit, inedible, portable; singular-named, proper-named
description: none
initial appearance: none
ring face: blank
printed name: "second ring"
printed plural name: "rings"
indefinite article: none
list grouping key: none
third ring - ring
location: on the column in the Poseidon's Temple
unlit, inedible, portable; singular-named, proper-named
description: none
initial appearance: none
ring face: blank
printed name: "third ring"
printed plural name: "rings"
indefinite article: none
list grouping key: none
bottom ring - ring
location: on the column in the Poseidon's Temple
unlit, inedible, portable; singular-named, proper-named
description: none
initial appearance: none
ring face: blank
printed name: "bottom ring"
printed plural name: "rings"
indefinite article: none
list grouping key: none

* * *

>smell aria
You smell nothing unexpected.

* * *

>smell candle
It smells like roses.

* * *

>smell empty scroll
It smells citrusy.

* * *

>smell flower
Which do you mean, a red flower, a purple flower, a yellow flower or a white flower?

>smell red flower
You smell nothing unexpected.

* * *

>smell red flower
It smells good.

>smell aria
You smell nothing unexpected.

>smell white flower
It smells amazing.

* * *

>smell zeus
Activelly trying to smell a person can be considered rude.

* * *

>statue
That's not a verb I recognise.

>examine statue
The statue depicts a beautiful man. He's holding a basket.  It has nothing inside

>pick up flowers
Taken.

>put flowers in basket
You put the red flowers into the basket.

>examine statue
The statue depicts a beautiful man. He's holding a basket. It has somethingothing inside.

>i
You are carrying nothing.

>examine flowers
You see nothing special about the red flowers.

>examine red flower
I only understood you as far as wanting to examine the red flowers.

>examine red flowers
You see nothing special about the red flowers.

>look
Secret Garden
You see many flowers

You can see a statue and a sign here.

* * *

>sw
You can't go that way.

>s
Agora of Athens

>sw
Port of Piraeus
TODO: Pireaus Description (where the player can go?)

* * *

>sail to cyprus
That noun did not make sense in this context.

>sail to paphos
You sail to the Port of Paphos.

Port of Paphos
The main port of the city of Paphos. From here you can travel abroad.

>sail to aulis
You cannot sail directly to Port of Aulis from here.

* * *

>sw
Port of Piraeus
TODO: Pireaus Description (where the player can go?)

>sail to paphos
You sail to Port of Paphos.

Port of Paphos
The main port of the city of Paphos. From here you can travel abroad.

>e
Agora of Paphos
The main square of Paphos.

>e
You can't go that way.

>e
You can't go that way.

>n
Outside of the Palace of Paphos

>n
Throne Room
Home to the King of Paphos, Cinyras.

You can see Cinyras here.

* * *

>swim in sea
The nereides agree to take you to the sunken Temple.

Poseidon's Temple
Description of temple of poseidon.

>d
Divine Cell 2
You see the gods.

You can see Poseidon and Demeter here.

* * *

>take 3 red flowers
red flower: You picked up a red flower.
red flower: You picked up a red flower.
red flower: You picked up a red flower.

* * *

>take carpet
You can't take the carpet if there are things on top of it.

>push table
You put all your strength into pushing the table off the carpet- and you manage it!

>pull chairs
You push the chairs off the carpet.

>pull carpet
You pulled the carpet
By pulling the carpet out of the way you revealed a trapdoor.

* * *

>take club
You picked up a Heracles' Club.

>give club to heracles
He smiles to you. "Thank you my dearest."

You give the Heracles' Club to the God Heracles.

>-
Suddenly, an eerie silence fell over the festive night. The singing and dancing ceased, as if an unseen hand had stilled them. For a brief moment, you felt the coldness of the mountain air, a stark contrast to the pleasant breeze that had enveloped you moments before. A sense of foreboding fills you as you become aware that all eyes are turned behind you. You lock eyes with Heracles, both of you sharing a look of worry. With a growing sense of dread, you turned to see what had drawn everyone's attention.

"Oh, please, do not allow me to ruin your little party. Please continue."

The voice was unmistakable, deep and resonant, carrying an ancient power that sent shivers down your spine. It was Kronos. But how-?

The sight of the Titan, towering and menacing, shrouded in shadows, struck fear into the hearts of all present. You start to feel the ambrosia in your divine veins turn cold, as if time itself had frozen. The gods, normally so mighty and formidable, stoand paralyzed in shock. Nothing moves. In an instant, you break free from the daze and come to your senses. Your next actions have never been more certain. It's now or never.

You grab Heracle's club out of his hands and leap towards Kronos. Then you feel yourself slipping into unconciousness.

>examine kronos
You can't see any such thing.

>s
You can't go that way.

>r
Garden of Hesperides
You can see Aigle, Arethousa, Erytheia and Hesperie here.

I beg your pardon?

* * *

>give club to heracles
He smiles to you. "Thank you my dearest."

You give the Heracles' Club to the God Heracles.

>[enter]
Suddenly, an eerie silence fell over the festive night. The singing and dancing ceased, as if an unseen hand had stilled them. For a brief moment, you felt the coldness of the mountain air, a stark contrast to the pleasant breeze that had enveloped you moments before. A sense of foreboding fills you as you become aware that all eyes are turned behind you. You lock eyes with Heracles, both of you sharing a look of worry. With a growing sense of dread, you turned to see what had drawn everyone's attention.

"Oh dear, please, do not let my presence taint your insignificant gathering. Carry on as you were."

The voice was unmistakable, deep and resonant, carrying an ancient power that sent shivers down your spine. It was Kronos. So much time has passed since our triumph in the War of Titans- the Titanomachy. How did he manage to escape Tartarus?

The sight of the Titan, towering and menacing, shrouded in shadows, struck fear into the hearts of all present. You start to feel the ambrosia in your divine veins turn cold, as if time itself had frozen. The gods, normally so mighty and formidable, stand paralyzed in shock. Nothing moves. In a heartbeat, you break free from the daze and come to your senses. Your next actions have never been more certain. It's now or never.

You grab Heracle's club out of his hands and leap towards Kronos. Then you feel yourself slipping into unconciousness.

* * *

>[enter]
Garden of Hesperides
1-2 months timeskip. the nymphs tended to your wounds and restored you with nectar and ambrosia. They tell you what happened with the gods and send you towards the oracle of delphi.

From here you can sail to: 
→ Piraeus
→ Sounio
→ Aulis
→ Paphos

You can see Aigle, Arethousa, Erytheia and Hesperie here.

>sail to athens
That noun did not make sense in this context.

>sail to athina
That noun did not make sense in this context.

>take piraeus
You can't see any such thing.

>sail to patra
That noun did not make sense in this context.

>sail to cyprus
That noun did not make sense in this context.

>l
Garden of Hesperides
1-2 months timeskip. the nymphs tended to your wounds and restored you with nectar and ambrosia. They tell you what happened with the gods and send you towards the oracle of delphi.

From here you can sail to: 
→ Piraeus
→ Sounio
→ Aulis
→ Paphos

You can see Aigle, Arethousa, Erytheia and Hesperie here.

>x aigle
You see nothing special about Aigle.

>take Aigle
I don't suppose Aigle would care for that.

>smell aigle
It smells neutral.

>x hesperie
You see nothing special about Hesperie.

>sail to Piraeus
You sail to the Port of Piraeus.

Port of Piraeus
From here you can sail to: 
→ Paphos
→ Garden of Hesperides

I beg your pardon?

>l
Port of Piraeus
From here you can sail to: 
→ Paphos
→ Garden of Hesperides

>l
Port of Piraeus
From here you can sail to: 
→ Paphos
→ Garden of Hesperides

>sail to paphos
You sail to the Port of Paphos.

Port of Paphos
The main port of the city of Paphos. 

From here you can sail to: 
→ Piraeus
→ Garden of Hesperides

>l
Port of Paphos
The main port of the city of Paphos. 

From here you can sail to: 
→ Piraeus
→ Garden of Hesperides

>sail to garden
You sail to the Garden of Hesperides.

Garden of Hesperides
1-2 months timeskip. the nymphs tended to your wounds and restored you with nectar and ambrosia. They tell you what happened with the gods and send you towards the oracle of delphi.

From here you can sail to: 
→ Piraeus
→ Sounio
→ Aulis
→ Paphos

You can see Aigle, Arethousa, Erytheia and Hesperie here.

>sail to sounio
You sail to the Port of Sounio.

Port of Sounio
From here you can sail to: 
→ Aulis
→ Garden of Hesperides

>sail to aulis
You sail to the Port of Aulis.

Port of Aulis
From here you can sail to: 
→ Sounio
→ Garden of Hesperides

>sail to sounio
You sail to the Port of Sounio.

Port of Sounio
From here you can sail to: 
→ Aulis
→ Garden of Hesperides

>sail to garden
You sail to the Garden of Hesperides.

Garden of Hesperides
1-2 months timeskip. the nymphs tended to your wounds and restored you with nectar and ambrosia. They tell you what happened with the gods and send you towards the oracle of delphi.

From here you can sail to: 
→ Piraeus
→ Sounio
→ Aulis
→ Paphos

You can see Aigle, Arethousa, Erytheia and Hesperie here.

>sail to paphos
You sail to the Port of Paphos.

Port of Paphos
The main port of the city of Paphos. 

From here you can sail to: 
→ Piraeus
→ Garden of Hesperides

>sail to cyprus
That noun did not make sense in this context.

>l
Port of Paphos
The main port of the city of Paphos. 

From here you can sail to: 
→ Piraeus
→ Garden of Hesperides

* * *

>sail to garden
You sail to the Garden of Hesperides.

Garden of Hesperides
1-2 months timeskip. the nymphs tended to your wounds and restored you with nectar and ambrosia. They tell you what happened with the gods and send you towards the oracle of delphi.

From here you can sail to: 
→ Piraeus
→ Sounio
→ Aulis
→ Paphos

You can see Aigle, Arethousa, Erytheia and Hesperie here.

>sail to piraues
That noun did not make sense in this context.

>sail to piraeus
You sail to the Port of Piraeus.

Port of Piraeus
From here you can sail to: 
→ Paphos
→ Garden of Hesperides

>l
Port of Piraeus
From here you can sail to: 
→ Paphos
→ Garden of Hesperides

>go dw
You can't see any such thing.

>go sw
You can't go that way.

>go ne
Agora of Athens

>l
Agora of Athens

>go e
Acropolis

>l
Acropolis

>l
Acropolis

>go in prytaneion
You went into the prytaneion
Prytaneion
TODO simple description

You can see a porta, a portable torch, a first torch, a second torch, a third torch, a fourth torch, a fifth torch, a sixth torch, a seventh torch, an eighth torch, a ninth torch, a tenth torch, an eleventh torch, a twelfth torch, a thirteenth torch, a fourteenth torch, a fifteenth torch, a sixteenth torch, an empty scroll, a wax tablet, a text scroll and a parchment here.

I beg your pardon?

>l
Prytaneion
TODO simple description

You can see a porta, a portable torch, a first torch, a second torch, a third torch, a fourth torch, a fifth torch, a sixth torch, a seventh torch, an eighth torch, a ninth torch, a tenth torch, an eleventh torch, a twelfth torch, a thirteenth torch, a fourteenth torch, a fifteenth torch, a sixteenth torch, an empty scroll, a wax tablet, a text scroll and a parchment here.

>take torches
portable torch: You picked up a portable torch.
first torch: You picked up a first torch.
second torch: You picked up a second torch.
third torch: You picked up a third torch.
fourth torch: You picked up a fourth torch.
fifth torch: You picked up a fifth torch.
sixth torch: You picked up a sixth torch.
seventh torch: You picked up a seventh torch.
eighth torch: You picked up a eighth torch.
ninth torch: You picked up a ninth torch.
tenth torch: You're carrying too many things already.
eleventh torch: You're carrying too many things already.
twelfth torch: You're carrying too many things already.
thirteenth torch: You're carrying too many things already.
fourteenth torch: You're carrying too many things already.
fifteenth torch: You're carrying too many things already.
sixteenth torch: You're carrying too many things already.

>put down torches
ninth torch: Dropped.
eighth torch: Dropped.
seventh torch: Dropped.
sixth torch: Dropped.
fifth torch: Dropped.
fourth torch: Dropped.
third torch: Dropped.
second torch: Dropped.
first torch: Dropped.
portable torch: Dropped.

>take portable torch
You picked up a portable torch.

>x torch
(the portable torch)
You see nothing special about the portable torch.

>smell torch
(the portable torch)
It smells neutral.

>put portable torch in first torch
That can't contain things.

>l
Prytaneion
TODO simple description

You can see a first torch, a second torch, a third torch, a fourth torch, a fifth torch, a sixth torch, a seventh torch, an eighth torch, a ninth torch, a porta, a tenth torch, an eleventh torch, a twelfth torch, a thirteenth torch, a fourteenth torch, a fifteenth torch, a sixteenth torch, an empty scroll, a wax tablet, a text scroll and a parchment here.

>take empty torch
I only understood you as far as wanting to take the empty scroll.

>take empty scroll
You picked up a empty scroll.

>x empty scroll
An empty scroll. Smells citrusy.

>smell empty torch
I only understood you as far as wanting to smell the empty scroll.

>smell empty scroll
It smells citrusy.

>take wax tablet
You picked up a wax tablet.

>x wax tablet
_  _ _ _ _  _ _ _ _ _ _  _ _ _ _  _ _ _ _ _  _ _.  _ _ _ _ _  _ _  _ _ _ _ _  _ _  _ _ _  _ _ _ _  _ _ _  _ _ _ _  _ _. 

S QWJC WOEBQCD  BCTB  PONCD UC. FDSOA  UC GZEIC BE BQC  VSDC WON  DCWN SB.

>x text scroll
On the scroll you read: Ortsg gsv hrcgs, gsv hvevmgs zmw gsv vrtsgs glixsvh.

>x parchment
On the parchment you read: Nkijv vjg ugeqpf cpf vjktf vqtejgu.

>light up torches
I only understood you as far as wanting to light up.

>light torches
You can't use multiple objects with that verb.

>light first torch
You lighted the first torch.

>turn off first torch
It isn't something you can switch.

>put off first torch
I didn't understand that sentence.

>put empty scroll on first torch
Putting things on the first torch would achieve nothing.

>burn empty scroll
This dangerous act would achieve little.

>light up empty scroll
I only understood you as far as wanting to light up.

>light empty scroll
This dangerous act would achieve little.

>put empty scroll in front of first torch
You can't see any such thing.

>l
Prytaneion
TODO simple description

You can see a first torch, a second torch, a third torch, a fourth torch, a fifth torch, a sixth torch, a seventh torch, an eighth torch, a ninth torch, a porta, a tenth torch, an eleventh torch, a twelfth torch, a thirteenth torch, a fourteenth torch, a fifteenth torch, a sixteenth torch, a text scroll and a parchment here.

>put empty scroll close to hearth
Ink starts to slowly appear on the papyrus, revealing a message.

>x empty scroll
The message says: Light the fourteenth, fifteenth and sixteenth torches.

>light fourteenth torch
You lighted the fourteenth torch.

>light fifteenth torch
You lighted the fifteenth torch.

>light 16 torch
You can't use multiple objects with that verb.

>light 16th torch
You lighted the sixteenth torch.

>l
Prytaneion
TODO simple description

You can see a first torch, a second torch, a third torch, a fourth torch, a fifth torch, a sixth torch, a seventh torch, an eighth torch, a ninth torch, a porta, a tenth torch, an eleventh torch, a twelfth torch, a thirteenth torch, a fourteenth torch, a fifteenth torch, a sixteenth torch, a text scroll and a parchment here.

>re.
That's not a verb I recognise.

>x text scroll
On the scroll you read: Ortsg gsv hrcgs, gsv hvevmgs zmw gsv vrtsgs glixsvh.

* * *

>x parchment
On the parchment you read: Nkijv vjg ugeqpf cpf vjktf vqtejgu.

I beg your pardon?

>l
Prytaneion
TODO simple description

You can see a first torch, a second torch, a third torch, a fourth torch, a fifth torch, a sixth torch, a seventh torch, an eighth torch, a ninth torch, a porta, a tenth torch, an eleventh torch, a twelfth torch, a thirteenth torch, a fourteenth torch, a fifteenth torch, a sixteenth torch, a text scroll and a parchment here.

>i
You are carrying:
  a wax tablet
  an empty scroll
  a portable torch

>x wax tablet
_  _ _ _ _  _ _ _ _ _ _  _ _ _ _  _ _ _ _ _  _ _.  _ _ _ _ _  _ _  _ _ _ _ _  _ _  _ _ _  _ _ _ _  _ _ _  _ _ _ _  _ _. 

S QWJC WOEBQCD  BCTB  PONCD UC. FDSOA  UC GZEIC BE BQC  VSDC WON  DCWN SB.

>put wax tablet close to hearth
The warmth of the hearth made the wax melt. It revealed some engraved writing under it.

>x wax tablet
The writing reads: Light the tenth, eleventh and thirteenth torches.

>x empty scroll
The message says: Light the fourteenth, fifteenth and sixteenth torches.

>light 10th torch
You lighted the tenth torch.

>light 11th torch
You lighted the eleventh torch.

>light 13th torch
You lighted the thirteenth torch.

>l
Prytaneion
TODO simple description

You can see a first torch, a second torch, a third torch, a fourth torch, a fifth torch, a sixth torch, a seventh torch, an eighth torch, a ninth torch, a porta, a tenth torch, an eleventh torch, a twelfth torch, a thirteenth torch, a fourteenth torch, a fifteenth torch, a sixteenth torch, a text scroll and a parchment here.

>x text scroll
On the scroll you read: Ortsg gsv hrcgs, gsv hvevmgs zmw gsv vrtsgs glixsvh.

>put text scroll close to hearth
Hmm this won't achieve anything.

>x
What do you want to examine?

>x text scroll
On the scroll you read: Ortsg gsv hrcgs, gsv hvevmgs zmw gsv vrtsgs glixsvh.

* * *

>x parchment
On the parchment you read: Nkijv vjg ugeqpf cpf vjktf vqtejgu.

>i
You are carrying:
  a wax tablet
  an empty scroll
  a portable torch

>x wax tablet
The writing reads: Light the tenth, eleventh and thirteenth torches.

>put down wax tablet
Dropped.

>put down empty scroll
Dropped.

>light portable torch
You lighted the portable torch.

>x text scroll
On the scroll you read: Ortsg gsv hrcgs, gsv hvevmgs zmw gsv vrtsgs glixsvh.

* * *

>x parchment
On the parchment you read: Nkijv vjg ugeqpf cpf vjktf vqtejgu.

>burn parchment
This dangerous act would achieve little.

>put parchment close to portable torch
I didn't understand that sentence.

>light the 6th torch
You lighted the sixth torch.

>light the 7th torch
You lighted the seventh torch.

>light the 8th torch
You lighted the eighth torch.

>l
Prytaneion
TODO simple description

You can see an empty scroll, a wax tablet, a first torch, a second torch, a third torch, a fourth torch, a fifth torch, a sixth torch, a seventh torch, an eighth torch, a ninth torch, a porta, a tenth torch, an eleventh torch, a twelfth torch, a thirteenth torch, a fourteenth torch, a fifteenth torch, a sixteenth torch, a text scroll and a parchment here.

I beg your pardon?

>x text scroll
On the scroll you read: Ortsg gsv hrcgs, gsv hvevmgs zmw gsv vrtsgs glixsvh.

* * *

>x parchment
On the parchment you read: Nkijv vjg ugeqpf cpf vjktf vqtejgu.

>light the 2nd torch
You lighted the second torch.

>light the third torch
You lighted the third torch.

>take first torch
You picked up a first torch.

>put off first torch
I didn't understand that sentence.

>x first torch
You see nothing special about the first torch.

>light first torch
You lighted the first torch.

>unlight the first torch
That's not a verb I recognise.

>showme first torch
first torch - first torch
location: carried by yourself in Prytaneion
lit, inedible, portable, handled; singular-named, improper-named
description: none
initial appearance: none
smell: neutral
printed name: "first torch"
printed plural name: "first torches"
indefinite article: none
list grouping key: none

>drop first torch
Dropped.

>showme first torch
first torch - first torch
location: in Prytaneion
lit, inedible, portable, handled; singular-named, improper-named
description: none
initial appearance: none
smell: neutral
printed name: "first torch"
printed plural name: "first torches"
indefinite article: none
list grouping key: none

>take first torch
You picked up a first torch.

>showme first torch
first torch - first torch
location: carried by yourself in Prytaneion
lit, inedible, portable, handled; singular-named, improper-named
description: none
initial appearance: none
smell: neutral
printed name: "first torch"
printed plural name: "first torches"
indefinite article: none
list grouping key: none

* * *

>showme first torch
first torch - first torch
location: in Prytaneion
lit, inedible, portable, handled; singular-named, improper-named
description: none
initial appearance: none
smell: neutral
printed name: "first torch"
printed plural name: "first torches"
indefinite article: none
list grouping key: none

>x
(the portable torch)
You see nothing special about the portable torch.

>l
Prytaneion
TODO simple description

You can see a first torch, an empty scroll, a wax tablet, a second torch, a third torch, a fourth torch, a fifth torch, a sixth torch, a seventh torch, an eighth torch, a ninth torch, a porta, a tenth torch, an eleventh torch, a twelfth torch, a thirteenth torch, a fourteenth torch, a fifteenth torch, a sixteenth torch, a text scroll and a parchment here.

>x
(the portable torch)
You see nothing special about the portable torch.

>x
(the portable torch)
You see nothing special about the portable torch.

I beg your pardon?

>x
(the portable torch)
You see nothing special about the portable torch.

>i
You are carrying:
  a portable torch (providing light)

>l
Prytaneion
TODO simple description

You can see a first torch, an empty scroll, a wax tablet, a second torch, a third torch, a fourth torch, a fifth torch, a sixth torch, a seventh torch, an eighth torch, a ninth torch, a porta, a tenth torch, an eleventh torch, a twelfth torch, a thirteenth torch, a fourteenth torch, a fifteenth torch, a sixteenth torch, a text scroll and a parchment here.

* * *

>give club to heracles
He smiles to you. "Thank you my dearest."

You give the Heracles' Club to the God Heracles.

>i
You are carrying:
  a Heracles' Club

Kronos Scene ended
Garden of Hesperides
You can see Aigle, Arethousa, Erytheia and Hesperie here.

* * *

>give club to heracles
He smiles to you. "Thank you my dearest."

You give the Heracles' Club to the God Heracles.

>o
Suddenly, an eerie silence fell over the festive night. The singing and dancing ceased, as if an unseen hand had stilled them. For a brief moment, you felt the coldness of the mountain air, a stark contrast to the pleasant breeze that had enveloped you moments before. A sense of foreboding fills you as you become aware that all eyes are turned behind you. You lock eyes with Heracles, both of you sharing a look of worry. With a growing sense of dread, you turned to see what had drawn everyone's attention.

"Oh, please, do not allow me to ruin your little party. Please continue."

The voice was unmistakable, deep and resonant, carrying an ancient power that sent shivers down your spine. It was Kronos. But how-? The sight of the Titan, towering and menacing, shrouded in shadows, struck fear into the hearts of all present. You start to feel the ambrosia in your divine veins turn cold, as if time itself had frozen. The gods, normally so mighty and formidable, stoand paralyzed in shock. Nothing moves. In an instant, you break free from the daze and come to your senses. Your next actions have never been more certain. It's now or never.

You grab Heracle's club out of his hands and leap towards Kronos. Then you feel yourself slipping into unconciousness.

>i
You are carrying nothing.

Kronos Scene ended
Garden of Hesperides
You can see Aigle, Arethousa, Erytheia and Hesperie here.

* * *

>take club
You picked up a Heracles' Club.

>give club to hercules
You can't see any such thing.

>scenes
Scene 'Entire Game' playing (for 1 mins now)
Scene 'Olympus Hall Celebration Scene' playing (for 1 mins now)
(Scene monitoring now switched on. Type "scenes off" to switch it off again.)

>give club to heracles
He smiles to you. "Thank you my dearest."

You give the Heracles' Club to the God Heracles.

[Scene 'Olympus Hall Celebration Scene' ends]
[Scene 'Kronos Scene' begins]

>i
Suddenly, an eerie silence fell over the festive night. The singing and dancing ceased, as if an unseen hand had stilled them. For a brief moment, you felt the coldness of the mountain air, a stark contrast to the pleasant breeze that had enveloped you moments before. A sense of foreboding fills you as you become aware that all eyes are turned behind you. You lock eyes with Heracles, both of you sharing a look of worry. With a growing sense of dread, you turned to see what had drawn everyone's attention.

"Oh, please, do not allow me to ruin your little party. Please continue."

The voice was unmistakable, deep and resonant, carrying an ancient power that sent shivers down your spine. It was Kronos. But how-?

The sight of the Titan, towering and menacing, shrouded in shadows, struck fear into the hearts of all present. You start to feel the ambrosia in your divine veins turn cold, as if time itself had frozen. The gods, normally so mighty and formidable, stoand paralyzed in shock. Nothing moves. In an instant, you break free from the daze and come to your senses. Your next actions have never been more certain. It's now or never.

You grab Heracle's club out of his hands and leap towards Kronos. Then you feel yourself slipping into unconciousness.

[Scene 'Kronos Scene' ends]

>d
Garden of Hesperides
You can see Aigle, Arethousa, Erytheia and Hesperie here.

>sail to piraeus
You sail to the Port of Piraeus.

Port of Piraeus
From here you can sail to: 
→ Paphos
→ Garden of Hesperides

* * *

>take club
You picked up a Heracles' Club.

>give hercules the club
You can't see any such thing.

>give the club to hercules
You can't see any such thing.

>give heracles the club
He smiles to you. "Thank you my dearest."

You give the Heracles' Club to the God Heracles.

>[enter]
Suddenly, an eerie silence fell over the festive night. The singing and dancing ceased, as if an unseen hand had stilled them. For a brief moment, you felt the coldness of the mountain air, a stark contrast to the pleasant breeze that had enveloped you moments before. A sense of foreboding fills you as you become aware that all eyes are turned behind you. You lock eyes with Heracles, both of you sharing a look of worry. With a growing sense of dread, you turned to see what had drawn everyone's attention.

"Oh dear, please, do not let my presence taint your insignificant gathering. Carry on as you were."

The voice was unmistakable, deep and resonant, carrying an ancient power that sent shivers down your spine. It was Kronos. So much time has passed since our triumph in the War of Titans- the Titanomachy. How did he manage to escape Tartarus?

The sight of the Titan, towering and menacing, shrouded in shadows, struck fear into the hearts of all present. You start to feel the ambrosia in your divine veins turn cold, as if time itself had frozen. The gods, normally so mighty and formidable, stand paralyzed in shock. Nothing moves. In a heartbeat, you break free from the daze and come to your senses. Your next actions have never been more certain. It's now or never.

You grab Heracle's club out of his hands and leap towards Kronos. Then you feel yourself slipping into unconciousness.

* * *

>[enter]
Garden of Hesperides
1-2 months timeskip. the nymphs tended to your wounds and restored you with nectar and ambrosia. They tell you what happened with the gods and send you towards the oracle of delphi.

From here you can sail to: 
→ Piraeus
→ Sounio
→ Aulis
→ Paphos

You can see Aigle, Arethousa, Erytheia and Hesperie here.

>sail to piraeus
You sail to the Port of Piraeus.

Port of Piraeus
From here you can sail to: 
→ Paphos
→ Garden of Hesperides

* * *

>ne
Agora of Athens

>sw
Port of Piraeus
From here you can sail to: 
→ Paphos
→ Garden of Hesperides

>ne
Agora of Athens

>se
Southern Gates of Athens
From here you can travel to: 
→ Sounio

>nw
Agora of Athens

>n
Northen Gates of Athens
From here you can travel to: 
→ Thebes
→ Aulis
→ Delphi
→ Ephyra
→ Mount Olympus

>s
Agora of Athens

* * *

>e
Acropolis

>prytaneion
That's not a verb I recognise.

>go to prytaneion
You can't see any such thing.

>go in prytaneion'
You went into the prytaneion
Prytaneion
TODO simple description

You can see a porta, a portable torch, a first torch, a second torch, a third torch, a fourth torch, a fifth torch, a sixth torch, a seventh torch, an eighth torch, a ninth torch, a tenth torch, an eleventh torch, a twelfth torch, a thirteenth torch, a fourteenth torch, a fifteenth torch, a sixteenth torch, an empty scroll, a wax tablet, a text scroll and a parchment here.

* * *

>take club
You picked up a Heracles' Club.

>look
Mount Olympus Hall
You can see Heracles, Zeus, Hera, Demeter, Hestia, Poseidon, Aphrodite, Apollo, Artemis, Athena, Ares, Dionysus, Hephaestus and Hermes. Ganymedes is running around, serving nectar on request.

Kronos Scene ended
Garden of Hesperides
You can see Aigle, Arethousa, Erytheia and Hesperie here.

* * *

>take first torch
You picked up a first torch.

>bring first torch close to hearth
I didn't understand that sentence.

>bring first torch close to the hearth
Hmm this won't achieve anything

>bring wax tablet close to the hearth
The warmth of the hearth made the wax melt. It revealed some engraved text under it.

>put wax tablet close to the hearth
The warmth of the hearth made the wax melt. It revealed some engraved text under it.

>x wax tablet
The

* * *

>take flower
Which do you mean, a red flower, a purple flower, a yellow flower or a white flower?

>take red flower
I only understood you as far as wanting to take 10 Red Flowers.

>take flowerkind
You can't see any such thing.

* * *

>take flower
Which do you mean, a red flower, a purple flower, a yellow flower or a white flower?

>x lake
It's a beautiful lake full of colourfull waterlilies.

* * *

>x lake
Poseidon's Power flows through your vains. You can clearly see an underwather path. You wonder if it actually leads you where you should be.

>d
You can't go that way.

>go in lake
You swim through the waters.

You can't go that way.

>u
Throne Room
Home to the King of Paphos, Cinyras.

You can see Cinyras here.

>e
Agora of Paphos
The main square of Paphos.

>w
Throne Room
Home to the King of Paphos, Cinyras.

You can see Cinyras here.

>u
You can't go that way.

>d
Secret Garden
You are in the Secret Garden. You can see red, purple, yellow and white flowers planted in some flowerbeds. In your right you can see some golden amphorae. In the middle of the garden you see an enormous tree with a cavity in the middle. You see lake with shells in the shore. A heavy looking gate that seems to lead to the next room is on the eastern side of the garden, its view mostly obstructed by vines and flowers. In the garden you see a statue of a beautiful man.

>e
You can't go that way.

* * *

>w
You can't go that way.

>s
You can't go that way.

* * *

>n
You can't go that way.

>showme gate
puzzle gate - closed door
location: in the Secret Garden
unlit, inedible, fixed in place; closed, unopenable, unlocked; singular-named, improper-named
description: none
initial appearance: none
leading-through destination: <routine 215633>
printed name: "puzzle gate"
printed plural name: "doors"
indefinite article: none
list grouping key: none

>open gate
It isn't something you can open.

>unlock gate
What do you want to unlock the puzzle gate with?

* * *

>take flowers
red flower: You picked up a red flower.
red flower: You picked up a red flower.
red flower: You picked up a red flower.
red flower: You picked up a red flower.
red flower: You picked up a red flower.
red flower: You picked up a red flower.
red flower: You picked up a red flower.
red flower: You picked up a red flower.
red flower: You picked up a red flower.
red flower: You picked up a red flower.
purple flower: You're carrying too many things already.
purple flower: You're carrying too many things already.
purple flower: You're carrying too many things already.
purple flower: You're carrying too many things already.
purple flower: You're carrying too many things already.
purple flower: You're carrying too many things already.
purple flower: You're carrying too many things already.
purple flower: You're carrying too many things already.
purple flower: You're carrying too many things already.
purple flower: You're carrying too many things already.
yellow flower: You're carrying too many things already.
yellow flower: You're carrying too many things already.
yellow flower: You're carrying too many things already.
yellow flower: You're carrying too many things already.
yellow flower: You're carrying too many things already.
yellow flower: You're carrying too many things already.
yellow flower: You're carrying too many things already.
yellow flower: You're carrying too many things already.
yellow flower: You're carrying too many things already.
yellow flower: You're carrying too many things already.
white flower: You're carrying too many things already.
white flower: You're carrying too many things already.
white flower: You're carrying too many things already.
white flower: You're carrying too many things already.
white flower: You're carrying too many things already.
white flower: You're carrying too many things already.
white flower: You're carrying too many things already.
white flower: You're carrying too many things already.
white flower: You're carrying too many things already.
white flower: You're carrying too many things already.

>i
You are carrying:
  ten red flowers

>player
That's not a verb I recognise.

* * *

>take left pan
That seems to be a part of the scale.

>x scale
You see nothing special about the scale.

* * *

>take moon key
You picked up a moon key.

* * *

>take sun key
You picked up a sun key.

>unlock dvdoor
You put the sun key into the sun lock.

You put the moon key into the moon lock.

unlocking the door
You hear the sound of the gate mechanism unlocking

>take sun key
You picked up a sun key.

You hear the sound of the gate mechanism locking.

>showme dvdoor
dvdoor - locked door
    sun lock (part of dvdoor) - open container
    moon lock (part of dvdoor) - open container
        moon key
location: in the Temple of the Aulidean Artemis
unlit, inedible, fixed in place; closed, openable, lockable, locked; singular-named, improper-named
description: none
initial appearance: "You can see one sun lock and one moon lock on the door."
leading-through destination: <routine 219770>
printed name: "dvdoor"
printed plural name: "doors"
indefinite article: none
list grouping key: none

* * *

>i
You are carrying:
  a moon key

* * *

>unlock dvdoor with moon key
That doesn't seem to fit the lock.

* * *

>take obol
You can't see any such thing.

>give club to heracles
(first taking the Heracles' Club)
You picked up a Heracles' Club.

He smiles to you. "Thank you my dearest."

You give the Heracles' Club to the God Heracles.

* * *

>n
North of Ephyra

>enter necromateion
You can't see any such thing.

>enter necromanteion
You went into the necromanteion
Necromanteion
You can see a necromanteion altar and a flower here.

>take flower
You picked up a flower.

>sacrifice flower
You put the flower on the altar and you chant some words.

You picked up a Obol.

>i
You are carrying:
  an Obol
  a Heracles' Club

>drop
What do you want to drop?

>l
Necromanteion
You can see a necromanteion altar here.

>showme obo
There seems to be no such object anywhere in the model world.

>showme obol
Obol - thing
location: carried by yourself in the Necromanteion
unlit, inedible, portable, handled; singular-named, improper-named
description: none
initial appearance: none
smell: neutral
printed name: "Obol"
printed plural name: none
indefinite article: none
list grouping key: none

* * *

>take obol
You can't see any such thing.

>i
You are carrying nothing.

>take club
You picked up a Heracles' Club.

Taken.

>give club to heracles
He smiles to you. "Thank you my dearest."

You give the Heracles' Club to the God Heracles.

>[enter]
Suddenly, an eerie silence fell over the festive night. The singing and dancing ceased, as if an unseen hand had stilled them. For a brief moment, you felt the coldness of the mountain air, a stark contrast to the pleasant breeze that had enveloped you moments before. A sense of foreboding fills you as you become aware that all eyes are turned behind you. You lock eyes with Heracles, both of you sharing a look of worry. With a growing sense of dread, you turned to see what had drawn everyone's attention.

"Oh dear, please, do not let my presence taint your insignificant gathering. Carry on as you were."

The voice was unmistakable, deep and resonant, carrying an ancient power that sent shivers down your spine. It was Kronos. So much time has passed since our triumph in the War of Titans- the Titanomachy. How did he manage to escape Tartarus?

The sight of the Titan, towering and menacing, shrouded in shadows, struck fear into the hearts of all present. You start to feel the ichor in your divine veins turn cold, as if time itself had frozen. The gods, normally so mighty and formidable, stand paralyzed in shock. Nothing moves. In a heartbeat, you break free from the daze and come to your senses. Your next actions have never been more certain. It's now or never.

You grab Heracle's club out of his hands and leap towards Kronos. Then you feel yourself slipping into unconciousness.

* * *

>[enter]
Garden of Hesperides

From here you can sail to: 
→ Piraeus
→ Sounio
→ Aulis
→ Paphos

You can see Eternal Chalice of Nectar, Aigle, Arethousa, Erytheia and Hesperie here.

>i
You are carrying:
  a Heracles' Club
  an obol

>sail to aulis
You sail to the Port of Aulis.

Port of Aulis
From here you can sail to: 
→ Sounio
→ Garden of Hesperides

* * *

>sacrifice flower
(first taking the flower)
You picked up a flower.

You put the flower on the altar and, with the help of the Priestess, you light it on fire. Persephone acknowledges you.

You gained an obol from the sacrifice.

>i
You are carrying:
  2 obols
  a Heracles' Club

>sacrifice the Heracles club
You can't see any such thing.

>sacrifice the club
You shouldn't sacrifice something that isn't yours to sacrifice.

>out
North of Ephyra

* * *

>s
Gates of Ephyra
From here you can travel to: 
→ Mount Olympus 
→ Athens
→ Thebes
→ Aulis
→ Delphi

>travel to aulis
You travel to the Gates of Aulis.

Gates of Aulis
From here you can travel to: 
→ Thebes
→ Athens
→  Delphi
→ Ephyra
→ Mount Olympus

>e
You can't go that way.

* * *

>w
You can't go that way.

>n
Agora of Aulis

>enter temple
You went into the temple of the aulidean artemis
Temple of the Aulidean Artemis
Inside the Temple of the Aulidean Artemis you can see a sundial, the statue of Artemis and her sacrificial altar.

>wait until midday
It is twelve o'clock now.

At twelve o'clock  you hear the click of a latch releasing and a sun hatch opening coming from the dial.

>take key
You picked up a sun key.

Taken.

>sacrifice key
The only gods that can see your sacrifice right now are the Cthonians. You will need to go to the Necromanteion.

* * *

>take portable torch
You picked up a portable torch.

* * *

>take red flower
You picked up a red flower.

>i
You are carrying:
  a red flower
  an aria

>go in lake
You can't. All you can see is dirty water.

>x lake
Poseidon's Power flows through your vains. You can clearly see an underwather path. You wonder if it actually leads you where you should be.

>go in lake
You swim through the waters.

Divine Cell 4
devine cell 4 description TODO

You can see Aphrodite and Hephaestus here.

* * *

>take red flower
You picked up a red flower.

>put red flower in red flowerbed
You plant the red flower into the red flowerbed

* * *

>x lake
Poseidon's Power flows through your vains. You can clearly see an underwather path. You wonder if it actually leads you where you should be.

>showme lake
lake - open door
location: in the Secret Garden
unlit, inedible, fixed in place; open, unopenable, unlocked; singular-named, improper-named
description: none
initial appearance: none
leading-through destination: <routine 215796>
printed name: "lake"
printed plural name: "doors"
indefinite article: none
list grouping key: none

>enter lake
You swim through the waters.

You can't go that way.

>i
You are carrying:
  a red flower
  an aria

* * *

>showme lake
lake - open door
location: in the Secret Garden
unlit, inedible, fixed in place; open, unopenable, unlocked; singular-named, improper-named
description: none
initial appearance: none
leading-through destination: <routine 215796>
printed name: "lake"
printed plural name: "doors"
indefinite article: none
list grouping key: none

>d
You look at the lake. Maybe you can go down through there.

You swim through the waters.

You can't go that way.

* * *

>l
Secret Garden
You are in the Secret Garden. You can see red, purple, yellow and white flowers planted in some flowerbeds. In your right you can see some golden amphorae. In the middle of the garden you see an enormous tree with a cavity in the middle. You see lake with shells in the shore. A heavy looking gate that seems to lead to the next room is on the eastern side of the garden, its view mostly obstructed by vines and flowers. In the garden you see a statue of a beautiful man.

>test 1
(Testing.)

>[1] put red flower in hand
You place the red flower in the statue's right hand.

>[2] put purple flower in conch shell
(first taking the purple flower)
You picked up a purple flower.

You put the purple flower into the conch shell.

>[3] put yellow flower in shiny amphora
(first taking the yellow flower)
You picked up a yellow flower.

You put the yellow flower into the shiny amphora.

>[4] put white flower in tree cavity
(first taking the white flower)
You picked up a white flower.

You put the white flower into the tree cavity.

You hear the sound of the gate opening

>x gate
The puzzle gate is now open.

>go in gate
Divine Cell 4
devine cell 4 description TODO

You can see Aphrodite and Hephaestus here.

>showme gate
puzzle gate - open door
location: in Divine Cell 4
unlit, inedible, fixed in place, scenery; open, unopenable, unlocked; singular-named, improper-named
description: none
initial appearance: none
leading-through destination: <routine 215706>
printed name: "puzzle gate"
printed plural name: "doors"
indefinite article: none
list grouping key: none

>go e
You can't go that way.

* * *

>take red flower
You picked up a red flower.

>take all flowers
red flower: You picked up a red flower.
red flower: You picked up a red flower.
red flower: You picked up a red flower.
red flower: You picked up a red flower.
red flower: You picked up a red flower.
red flower: You picked up a red flower.
red flower: You picked up a red flower.
red flower: You picked up a red flower.
red flower: You picked up a red flower.
purple flower: You picked up a purple flower.
purple flower: You picked up a purple flower.
purple flower: You picked up a purple flower.
purple flower: You picked up a purple flower.
purple flower: You picked up a purple flower.
purple flower: You picked up a purple flower.
purple flower: You picked up a purple flower.
purple flower: You picked up a purple flower.
purple flower: You picked up a purple flower.
purple flower: You picked up a purple flower.
yellow flower: You picked up a yellow flower.
yellow flower: You picked up a yellow flower.
yellow flower: You picked up a yellow flower.
yellow flower: You picked up a yellow flower.
yellow flower: You picked up a yellow flower.
yellow flower: You picked up a yellow flower.
yellow flower: You picked up a yellow flower.
yellow flower: You picked up a yellow flower.
yellow flower: You picked up a yellow flower.
yellow flower: You picked up a yellow flower.
white flower: You picked up a  white flower.
white flower: You picked up a  white flower.
white flower: You picked up a  white flower.
white flower: You picked up a  white flower.
white flower: You picked up a  white flower.
white flower: You picked up a  white flower.
white flower: You picked up a  white flower.
white flower: You picked up a  white flower.
white flower: You picked up a  white flower.
white flower: You picked up a  white flower.

>x red flowerbed
You picked up every red flower.

>put red flower in red flowerbed
You put the red flower into the red flowerbed.

* * *

>take red flower
You picked up a red flower.

>x
What do you want to examine?

>red flower
This is an Adonis Flower.

>put red flower in flowerbed
Which do you mean, the red flowerbed, the purple flowerbed or the orange flowerbed?

>red flowerbed
You plant the red flower into the red flowerbed.

>i
You are carrying nothing.

>x flower
(the flower gate)
The gate is tightly locked.

* * *

>take red flower
You picked up a red flower.

>x lake
Poseidon's Power flows through your vains. You can clearly see an underwather path. You wonder if it actuallly leads you where you should be.

>go in lake
You swim through the waters.

Divine Cell 4
You see the gods sleeping

 You can see a body of water in the ceiling.  That must be the bottom of the lake.

 The puzzle door from before is behind you.

You can also see Aphrodite and Hephaestus here.

>u
Secret Garden
You are in the Secret Garden. You can see red, purple, yellow and white flowers planted in some flowerbeds. In your right you can see some golden amphorae. In the middle of the garden you see an enormous tree with a cavity in the middle

 You see a lake. On its shore you see some seashells.   That must be the bottom of the lake.

A heavy looking gate that seems to lead to the next room is on the eastern side of the garden, its view mostly obstructed by vines and flowers.

In the garden you see a statue of a beautiful man.

* * *

>take red flowers
red flower: You picked up a red flower.
red flower: You picked up a red flower.
red flower: You picked up a red flower.
red flower: You picked up a red flower.
red flower: You picked up a red flower.
red flower: You picked up a red flower.
red flower: You picked up a red flower.
red flower: You picked up a red flower.
red flower: You picked up a red flower.
red flower: You picked up a red flower.

>i
You are carrying:
  ten red flowers

>put a red flower in the hands
You place the red flower in the statue's hands.

>i
You are carrying:
  nine red flowers

>take red flower from the hands
You picked up a red flower.

>x hands
The hands are empty

>i
You are carrying:
  ten red flowers

* * *

>take scrolls
You need to specify which scroll you want to take.

* * *

>take sun key
You picked up a sun key.

>take moon key
You picked up a moon key.

>put moon key in moon lock
You put the moon key into the moon lock.

>unlock dvgate with sunkey
You can't see any such thing.

>unlock dvgate with sun key
You can't see any such thing.

>unlock dvdoor with sun key
unlocking the door

>showme door
temple door - closed door
location: in the Poseidon's Temple
unlit, inedible, fixed in place; closed, unopenable, unlocked; singular-named, improper-named
description: none
initial appearance: none
leading-through destination: <routine 219350>
printed name: "temple door"
printed plural name: "doors"
indefinite article: none
list grouping key: none

>showme dvdoor
dvdoor - locked door
    sun lock (part of dvdoor) - open container
    moon lock (part of dvdoor) - open container
        moon key
location: in the Temple of the Aulidean Artemis
unlit, inedible, fixed in place; closed, openable, lockable, locked; singular-named, improper-named
description: none
initial appearance: "You can see one sun lock and one moon lock on the door."
leading-through destination: <routine 219718>
printed name: "dvdoor"
printed plural name: "doors"
indefinite article: none
list grouping key: none

>put sun key in sun lock
You put the sun key into the sun lock.

You hear the sound of the gate mechanism unlocking

>showme dvdoor
dvdoor - closed door
    sun lock (part of dvdoor) - open container
        sun key
    moon lock (part of dvdoor) - open container
        moon key
location: in the Temple of the Aulidean Artemis
unlit, inedible, fixed in place; closed, openable, lockable, unlocked; singular-named, improper-named
description: none
initial appearance: "You can see one sun lock and one moon lock on the door."
leading-through destination: <routine 219718>
printed name: "dvdoor"
printed plural name: "doors"
indefinite article: none
list grouping key: none

>open dvdoor
You open the dvdoor.

>showme dvdoor
dvdoor - open door
    sun lock (part of dvdoor) - open container
        sun key
    moon lock (part of dvdoor) - open container
        moon key
location: in the Temple of the Aulidean Artemis
unlit, inedible, fixed in place; open, openable, lockable, unlocked; singular-named, improper-named
description: none
initial appearance: "You can see one sun lock and one moon lock on the door."
leading-through destination: <routine 219718>
printed name: "dvdoor"
printed plural name: "doors"
indefinite article: none
list grouping key: none

* * *

>take moon key
You picked up a moon key.

>unlock the dvdoor with sunkey
You can't see any such thing.

>unlock the dvdoor with sun key
You put the sun key into the sun lock.

You put the moon key into the moon lock.

unlocking the door
You hear the sound of the gate mechanism unlocking

>unlock dvdoor with sun key
(first taking the sun key)
You picked up a sun key.

It seems like you need 2 keys for this door to unlock.

You hear the sound of the gate mechanism locking.

* * *

>take sun key
You picked up a sun key.

>unlock ddvdoor
You can't see any such thing.

>unlock dvdoor
oopsi no keys.

* * *

>take water lilies
You picked up a water lily.

>take more
You can't see any such thing.

>take water lilies
It would be a shame to remove more of those beautiful flowers. Frogs sleep in them!

>x
What do you want to examine?

I beg your pardon?

>x lily
It smells good.

>x statue
You can see a marble sign on the statue's base. His right hand looks like it could be holding something but there's nothing there.

* * *

>take water lily
You picked up a water lily.

>take water lily
It would be a shame to remove more of those beautiful flowers. Frogs sleep in them!

>i
You are carrying:
  a water lily
  an aria

>look
Secret Garden
You are in the Secret Garden. You can see red, purple, yellow and white flowers planted in some flowerbeds. In your right you can see some golden amphorae placed in a line. In the middle of the garden you see an enormous tree with a cavity in the middle. You see lake with shells in the shore. A heavy looking gate that seems to lead to the next room is on the eastern side of the garden, its view mostly obstructed by vines and blooms. In the garden you see a statue of a beautiful man.

>take water lilies
It would be a shame to remove more of those beautiful flowers. Frogs sleep in them!

* * *

>talk
That's not a verb I recognise.

>talk to Heracle
That's not a verb I recognise.

>look
Mountain Olympus Hall
Mountain Olympus Hall Description

You see your husband here.

You see a box

>open box
You open Magic Box, revealing a Hercule's Club.

>take
What do you want to take?

>hercules club
You can't see any such thing.

>look magic box
In Magic Box is a Hercule's Club.

>seach magic box
That's not a verb I recognise.

>search magic box
In Magic Box is a Hercule's Club.

>describe magic box
In Magic Box is a Hercule's Club.

* * *

>talk to heracles
That's not a verb I recognise.

>tell hi to heracles
You can't see any such thing.

>tell hi
You can't see any such thing.

>tell
I didn't understand that sentence.

>Tell to Heracles
You can't see any such thing.

>hi
That's not a verb I recognise.

>ask
What do you want to ask Heracles for?

>hi
You can't see any such thing.

>ask hi
You can't see any such thing.

>ask to heracles hi
You can't see any such thing.

>ask to heracles for hi
You can't see any such thing.

>ask to heracles for Hi
You can't see any such thing.

>talk
That's not a verb I recognise.

>tell
I didn't understand that sentence.

>tell to heracles
You can't see any such thing.

>tell to
You can't see any such thing.

>tell hi
You can't see any such thing.

>ask hi
You can't see any such thing.

>tell Heracles about hi
There is no reply.

>ask heracles about his day
There is no reply.

>ask Heracles about his day
There is no reply.

>ask Heracles about how he's doing
"Feeling amazing my dear!"

>ask Heracles his day
I didn't understand that sentence.

>tell heracles about his day
There is no reply.

>ask Heracles about day
There is no reply.

>sk Heracles about his day
That's not a verb I recognise.

>ask Heracles about his day
There is no reply.

>ask Heracles about how is his day
There is no reply.

* * *

>talk to heracles about his club
That's not a verb I recognise.

>tell heracles about his club
Ah its over there

>l
Mount Olympus Hall
Olympus Hall Celebration Description

You can see a Goddess Hestia, a Goddess Hera, a Goddess Demeter, a Goddess Athena, a Goddess Artemis, a Goddess Aphrodite, Ganymedes, a God Poseidon, a God Hermes, a God Ares, a God Hephaestus, a God Apollo, a God Zeus, a God Heracles and a Heracles' Club here.

>l
Mount Olympus Hall
Olympus Hall Celebration Description

You can see a Goddess Hestia, a Goddess Hera, a Goddess Demeter, a Goddess Athena, a Goddess Artemis, a Goddess Aphrodite, Ganymedes, a God Poseidon, a God Hermes, a God Ares, a God Hephaestus, a God Apollo, a God Zeus, a God Heracles and a Heracles' Club here.

>d
Foothills of Mount Olympus
From here you can travel to: 
→ Ephyra 
→ Athens
→ Thebes
→ Aulis
→ Delphi

* * *

>talk to hercules
That's not a verb I recognise.

>time
That's not a verb I recognise.

>i
You are carrying nothing.

* * *

>test 1
(Testing.)

>[1] put red flower in hand
You place the red flower in the statue's right hand.

>[2] put purple flower in conch shell
(first taking the purple flower)
You picked up a purple flower.

You put the purple flower into the conch shell.

>[3] put yellow flower in shiny amphora
(first taking the yellow flower)
You picked up a yellow flower.

You put the yellow flower into the shiny amphora.

>[4] put white flower in tree cavity
(first taking the white flower)
You picked up a white flower.

You put the white flower into the tree cavity.

You hear the sound of the gate opening

>showme gate
puzzle gate - open door
location: in the Secret Garden
unlit, inedible, fixed in place, scenery; open, unopenable, unlocked; singular-named, improper-named
description: none
initial appearance: none
leading-through destination: <routine 215706>
printed name: "puzzle gate"
printed plural name: "doors"
indefinite article: none
list grouping key: none

>go e
Divine Cell 4
devine cell 4 description TODO

You can see Aphrodite and Hephaestus here.

>go w
Secret Garden
You are in the Secret Garden. You can see red, purple, yellow and white flowers planted in some flowerbeds. In your right you can see some golden amphorae. In the middle of the garden you see an enormous tree with a cavity in the middle. You see lake with shells in the shore. A heavy looking gate that seems to lead to the next room is on the eastern side of the garden, its view mostly obstructed by vines and flowers. In the garden you see a statue of a beautiful man.

>x lake
It's a beautiful lake full of colourfull water lilies.

* * *

>go in lake
You can't. All you can see is dirty water.

>go d
You can't go down from here.

>take red flower
You picked up a red flower.

>d
You look at the lake. Maybe you can go down through there.

You swim through the waters.

Divine Cell 4
devine cell 4 description TODO

You can see Aphrodite and Hephaestus here.

* * *

>test 2
(Testing.)

>[1] put red flower in hand
You place the red flower in the statue's right hand.

>[2] x hand
You notice the number Α carved on its index finger.
It's holding a red flower.

>[3] take red flower from hand
You picked up a red flower.

>[4] x hand
You notice the number Α carved on its index finger.
It's not holding anything

* * *

>test art
(Testing.)

>[1] wait until 12 pm
It is twelve o'clock now.

At twelve o'clock you hear the sound of the sun pocket opening.

>[2] take sun key
You picked up a sun key.

>[3] wait until 12 am
At ten past twelve you hear the sound of the sun pocket closing.

It is twelve o'clock now.

At twelve o'clock you hear the sound of the moon pocket opening.

>[4] take moon key
You picked up a moon key.

>[5] put sun key in sun lock
You put the sun key in the sun-shapped lock.

You put the sun key into the sun lock.

>[6] put moon key in moon lock
You put the moon key in the moon-shapped lock.

You put the moon key into the moon lock.

You hear the sound of a locking mechanism unlocking.

>push statue
You push the statue away and you reveal a door leading under the temple. You open the door.

* * *

>x locking mechanism
You can't see the mechanism, but you can hear it inside the statue.

* * *

>x statue
The statue feels wobbly. Maybe you could try pushing it...

* * *

>push statue
You push the statue away and you reveal some stairs leading under the temple.

>go down
Divine Cell of Artemis & Apollo
You can see a Goddess Artemis and a God Apollo here.

>go down
You can't go that way.

>u
Temple of the Aulidean Artemis
You walk inside the Temple of Aulidean Artemis. First you observe the pronaos. Moonlight shines from the open ceiling on the big sundial standing in the middle of the room. Entering the naos, you can see a big golden Artemis" statue. She's holding a deer by the horns in her left hand and a bow in her other, both symbols of the virgin goddess. She is also carrying a quiver full of arrows. In front of her statue, you can see the altar of Artemis.

>push statue
The statue feels stuck. You can't push it back.

>x statue
You can see some stairs leading downstairs.

At ten past twelve you hear the sound of the moon pocket closing.

>u
You can't go that way.

>d
Divine Cell of Artemis & Apollo
You can see a Goddess Artemis and a God Apollo here.

>u
Temple of the Aulidean Artemis
You walk inside the Temple of Aulidean Artemis. First you observe the pronaos. Moonlight shines from the open ceiling on the big sundial standing in the middle of the room. Entering the naos, you can see a big golden Artemis" statue. She's holding a deer by the horns in her left hand and a bow in her other, both symbols of the virgin goddess. She is also carrying a quiver full of arrows. In front of her statue, you can see the altar of Artemis.

>x locking mechanism
You can't see the mechanism, but you can hear it inside the statue. Your best guess is that it kept the statue from revealing the stairs that lead under the temple.

* * *

>test ca
>--> The following tests are available:
'test cad'
'test pos'
'test solutionsg'
'test sg2'

>test cad
(Testing.)

>[1] x dragon statue
The statue's mouth is closed.

>[2] put rock on dragon head
(first taking the rock)
You picked up a rock.

You put the rock on the dragon head.

The statue's mouth opened.

>[3] x dragon statue
 You see 6 tooth inside the statue's mouth.

>[4] take 3 dragon teeth
dragon tooth: You picked up a dragon tooth.
dragon tooth: You picked up a dragon tooth.
dragon tooth: You picked up a dragon tooth.

>[5] x dragon statue
 You see 3 tooth inside the statue's mouth.

>[6] take 3 dragon teeth
dragon tooth: You picked up a dragon tooth.
dragon tooth: You picked up a dragon tooth.
dragon tooth: You picked up a dragon tooth.

>[7] x dragon statue
 There are no more teeth left in the statue's mouth.

>[8] take 1 dragon tooth
You already have that.

>i
You are carrying:
  six dragon teeth

* * *

>test cad
(Testing.)

>[1] x dragon statue
The statue's mouth is closed.

>[2] put rock on dragon head
(first taking the rock)
You picked up a rock.

You put the rock on the dragon head.

The statue's mouth opened.

>[3] x dragon statue
 You see 6 tooth inside the statue's mouth.

>[4] take 6 dragon teeth
dragon tooth: You picked up a dragon tooth.
dragon tooth: You picked up a dragon tooth.
dragon tooth: You picked up a dragon tooth.
dragon tooth: You picked up a dragon tooth.
dragon tooth: You picked up a dragon tooth.
dragon tooth: You picked up a dragon tooth.

>[5] put 6 dragon teeth in the plate
dragon tooth: Done.
dragon tooth: Done.
dragon tooth: Done.
dragon tooth: Done.
dragon tooth: Done.
dragon tooth: Done.

The dragon teeth are syphoned into the altar and a compartment door opens, exposing 6 weights.

>get weights
weight1: You picked up a weight1.
weight2: You picked up a weight2.
weight3: You picked up a weight3.
weight4: You picked up a weight4.

>put weight1 in left pan and put weight2 on right pan
I only understood you as far as wanting to put the weight1 in the left pan.

>put weight1 in left pan
That can't contain things.

>put weight2 in right pan
That can't contain things.

>x scale
The scale is currently centered.

>put weight3 in left pan
That can't contain things.

>x scale
The scale is currently centered.

>put weight3 on left pan and put weight4 on right pan
I only understood you as far as wanting to put the weight3 on the left pan.

>put weight3 on left pan and then put weight4 on right pan
You put the weight3 on the left pan.

You put the weight4 on the right pan.

>x scale
The scale is currently left-leaning.

* * *

>i
You are carrying:
  six dragon teeth

>put 6 dragon teeth in sacrificial plate
dragon tooth: Done.
dragon tooth: Done.
dragon tooth: Done.
dragon tooth: Done.
dragon tooth: Done.
dragon tooth: Done.

The dragon teeth are syphoned into the alter and a compartment door opens, exposing 6 dolls.

*** Run-time problem P16: You can't remove nothing from play.

* * *

>put all dragon teeth in plate
dragon tooth: Done.
dragon tooth: Done.
dragon tooth: Done.
dragon tooth: Done.
dragon tooth: Done.
dragon tooth: Done.

The dragon teeth are syphoned into the alter and a compartment door opens, exposing 6 dolls.

>x plate
In the sacrificial plate are six dragon teeth.

The dragon teeth are syphoned into the alter and a compartment door opens, exposing 6 dolls.

>x compartment
In the compartment are six dolls.

The dragon teeth are syphoned into the alter and a compartment door opens, exposing 6 dolls.

* * *

>take weights
weight1: You picked up a weight1.
weight2: You picked up a weight2.
weight3: You picked up a weight3.
weight4: You picked up a weight4.
weight5: You picked up a weight5.
weight6: You picked up a weight6.

>i
You are carrying:
  a weight6
  a weight5
  a weight4
  a weight3
  a weight2
  a weight1

>put weight1 on left pan
You put the weight1 on the left pan.

>x scale
The scale is currently left-leaning.

>put weight2 on left pan
You put the weight2 on the left pan.

>put weigh4 on left pan
You can't see any such thing.

>put weight4 on left pan
You put the weight4 on the left pan.

>x scale
The scale is currently left-leaning.

>take weight4
You picked up a weight4.

>put weight 4 on right pan
You can't see any such thing.

>put weight4 on right pan
You put the weight4 on the right pan.

>put weight5 on right pan
You put the weight5 on the right pan.

>put weight6 on right pan
You put the weight6 on the right pan.

* * *

>x scale
The scale is currently right-leaning.

>i
You are carrying:
  a weight3

>x left pan
On the left pan are a weight2 and a weight1.

>x right pan
On the right pan are a weight6, a weight5 and a weight4.

>put weight3 on right pan
You put the weight3 on the right pan.

>x scale
The scale is currently right-leaning.

>x left pan
On the left pan are a weight2 and a weight1.

>i
You are carrying nothing.

>x right pan
On the right pan are a weight3, a weight6, a weight5 and a weight4.

>take weight3
You picked up a weight3.

>take weight2
You picked up a weight2.

>x scale
The scale is currently right-leaning.

>x left pan
On the left pan is a weight1.

>x right pan
On the right pan are a weight6, a weight5 and a weight4.

>take all weights
weight1: You picked up a weight1.
weight6: You picked up a weight6.
weight5: You picked up a weight5.
weight4: You picked up a weight4.

>x scale
The scale is currently centered.

>i
You are carrying:
  a weight4
  a weight5
  a weight6
  a weight1
  a weight2
  a weight3

>put weight1 on right pan
You put the weight1 on the right pan.

>x scale
The scale is currently right-leaning.

>put weight4 on left pan
You put the weight4 on the left pan.

>x scale
The scale is currently right-leaning.

>x weight1
An owl

>x weight2
You see nothing special about the weight2.

* * *

>take weights
weight1: You picked up a weight1.
weight2: You picked up a weight2.
weight3: You picked up a weight3.
weight4: You picked up a weight4.
weight5: You picked up a weight5.
weight6: You picked up a weight6.

>put weight1 on pan1
You put the weight1 on the pan1.

* * *

>put weight4 on pan4
You put the weight4 on the pan4.

>put weight5 on pan5
You put the weight5 on the pan5.

>put weight6 on pan6
You put the weight6 on the pan6.

You hear the sound of the gate opening

* * *

>test gate
(Testing.)

>[1] take weights
weight1: You picked up a weight1.
weight2: You picked up a weight2.
weight3: You picked up a weight3.
weight4: You picked up a weight4.
weight5: You picked up a weight5.
weight6: You picked up a weight6.

>[2] put weight1 on pan1
You put the weight1 on the pan1.

>[3] put weight2 on pan2
You put the weight2 on the pan2.

>[4] put weight3 on pan3
You put the weight3 on the pan3.

>[5] put weight4 on pan4
You put the weight4 on the pan4.

>[6] put weight5 on pan5
You put the weight5 on the pan5.

>[7] put weight6 on pan6
You put the weight6 on the pan6.

You hear the sound of the gate mechanism unlocking

>open door
You can't see any such thing.

I beg your pardon?

>open gate
You open the dvgate.

>take weight1
You picked up a weight1.

You hear the sound of the gate mechanism locking, but the door is already open.

>go in gate
Divine Cell 1
You can see a dvgate here.

>u
Cadmea
on the walls you can see the story of cadmus, who slayed the Dragon of Ismenus and burried his teeth for the Spartoi to sprink from the ground. In front of you is a stone dragon statue, and a big chess board with some chess pieces already on top. You can see a sacrificial plate on top of the altar. The dvgate has a sign on it.

You can see a dvgate, a walls, dragon statue, a cadmea altar, a pan1, a pan2 (on which is a weight2), a pan3 (on which is a weight3), a pan4 (on which is a weight4), a pan5 (on which is a weight5), a pan6 (on which is a weight6) and a scale here.

>close gate
You close the dvgate.

>showme gate
(the dvgate)
dvgate - closed door
    dvsign (part of dvgate)
location: in Cadmea
unlit, inedible, fixed in place; closed, openable, lockable, unlocked; singular-named, improper-named
description: none
initial appearance: none
leading-through destination: <routine 218549>
printed name: "dvgate"
printed plural name: "doors"
indefinite article: none
list grouping key: none

>open gate
You open the dvgate.

>l
Cadmea
on the walls you can see the story of cadmus, who slayed the Dragon of Ismenus and burried his teeth for the Spartoi to sprink from the ground. In front of you is a stone dragon statue, and a big chess board with some chess pieces already on top. You can see a sacrificial plate on top of the altar. The dvgate has a sign on it.

You can see a dvgate, a walls, dragon statue, a cadmea altar, a pan1, a pan2 (on which is a weight2), a pan3 (on which is a weight3), a pan4 (on which is a weight4), a pan5 (on which is a weight5), a pan6 (on which is a weight6) and a scale here.

>close gate
You close the dvgate.

>put weight1 on pan1
You put the weight1 on the pan1.

You hear the sound of the gate mechanism unlocking

>take weight1
You picked up a weight1.

You hear the sound of the gate mechanism locking.

>open gate
It seems to be locked.

* * *

>open gate
You open the dvgate.

>take weight1
You picked up a weight1.

>x gate
The gate is locked.

>showme gate
(the dvgate)
dvgate - open door
    dvsign (part of dvgate)
location: in Cadmea
unlit, inedible, fixed in place; open, openable, lockable, unlocked; singular-named, improper-named
description: none
initial appearance: none
leading-through destination: <routine 218463>
printed name: "dvgate"
printed plural name: "doors"
indefinite article: none
list grouping key: none

* * *

>showme door
temple door - closed door
location: in the Poseidon's Temple
unlit, inedible, fixed in place; closed, unopenable, unlocked; singular-named, improper-named
description: none
initial appearance: none
leading-through destination: <routine 218702>
printed name: "temple door"
printed plural name: "doors"
indefinite article: none
list grouping key: none

* * *

>x gate
You can see there is a sign on the gate.

>showme gate
(the dvgate)
dvgate - closed door
    dvsign (part of dvgate)
location: in Cadmea
unlit, inedible, fixed in place; closed, openable, lockable, unlocked; singular-named, improper-named
description: none
initial appearance: none
leading-through destination: <routine 218536>
printed name: "dvgate"
printed plural name: "doors"
indefinite article: none
list grouping key: none

>go in gate
(first opening the dvgate)

Divine Cell 1
You can see a dvgate here.

>u
Cadmea
on the walls you can see the story of cadmus, who slayed the Dragon of Ismenus and burried his teeth for the Spartoi to sprink from the ground. In front of you is a stone dragon statue, and a big chess board with some chess pieces already on top. You can see a sacrificial plate on top of the altar.

You can see a dvgate, a walls, dragon statue, a cadmea altar, a pan1 (on which is a weight1), a pan2 (on which is a weight2), a pan3 (on which is a weight3), a pan4 (on which is a weight4), a pan5 (on which is a weight5), a pan6 (on which is a weight6) and a scale here.

>enter gate
Divine Cell 1
You can see a dvgate here.

* * *

>x gate
You can see there is a sign on the gate.

>x gate
You can see there is a sign on the gate.

* * *

>x compartment
In the compartment are a weight1, a weight2, a weight3 and a weight4.

* * *

>x dvgate
The gate is tightly closed.

>x scale
The scale is currently centered.

>put weigh1 and weight3 on left pan
You can't see any such thing.

>put weight1 and weight3 on left pan
weight1: (first taking the weight1)
You picked up a weight1.

Done.
weight3: (first taking the weight3)
You picked up a weight3.

Done.

You hear the sound of the gate opening

>showme scale
scale - thing
    left pan (part of scale) - supporter
        weight3 - weight
        weight1 - weight
    right pan (part of scale) - supporter
location: in Cadmea
unlit, inedible, fixed in place; singular-named, improper-named
description: "The scale is currently left-leaning."
initial appearance: none
printed name: "scale"
printed plural name: none
indefinite article: none
list grouping key: none

>showme dvgate
dvgate - open door
location: in Cadmea
unlit, inedible, fixed in place; open, unopenable, unlocked; singular-named, improper-named
description: none
initial appearance: none
leading-through destination: <routine 218390>
printed name: "dvgate"
printed plural name: "doors"
indefinite article: none
list grouping key: none

* * *

>x plate
The sacrificial plate is empty.

* * *

>test fire
(Testing.)

>[1] light second torch
You lighted the second torch.

>[2] light third torch
You lighted the third torch.

>[3] light sixth torch
You lighted the sixth torch.

>[4] light seventh torch
You lighted the seventh torch.

>[5] light eighth torch
You lighted the eighth torch.

>[6] light tenth torch
You lighted the tenth torch.

>[7] light eleventh torch
You lighted the eleventh torch.

>[8] light thirteenth torch
You lighted the thirteenth torch.

>[9] light fourteent torch
You lighted the fourteenth torch.

>[10] light fifteenth torch
You lighted the fifteenth torch.

>[11] light sixteenth torch
You lighted the sixteenth torch.

* * *

>test getweights
(Testing.)

>[1] x dragon statue
A small statue depicting a dragon. It is masterfully sculpted, with meticulous attention evident in every detail. Each scale is rendered with such precision that they appear almost lifelike, giving the dragon a sense of realism. 

The statue's mouth is closed.

>[2] put rock on dragon head
(first taking the rock)
You picked up a rock.

You put the rock on the dragon head.

You hear the sound of stone grinding against stone. The dragon statue's mouth opened.

>[3] x dragon statue
A small statue depicting a dragon. It is masterfully sculpted, with meticulous attention evident in every detail. Each scale is rendered with such precision that they appear almost lifelike, giving the dragon a sense of realism. 

 You see 6 tooth inside the statue's mouth.

>[4] take 6 dragon teeth
dragon tooth: You picked up a dragon tooth.
dragon tooth: You picked up a dragon tooth.
dragon tooth: You picked up a dragon tooth.
dragon tooth: You picked up a dragon tooth.
dragon tooth: You picked up a dragon tooth.
dragon tooth: You picked up a dragon tooth.

>[5] put 6 dragon teeth in the plate
dragon tooth: Done.
dragon tooth: Done.
dragon tooth: Done.
dragon tooth: Done.
dragon tooth: Done.
dragon tooth: Done.

The dragon teeth are syphoned into the altar and a compartment door opens, exposing 6 weights.

>test dragongate
(Testing.)

>[1] take weights
owl weight: You picked up an owl weight.
shield weight: You picked up a shield weight.
spear weight: You picked up a spear weight.
snake weight: You picked up a snake weight.
sword weight: You picked up a sword weight.
horse weight: You picked up a horse weight.

>[2] put owl weight on first pan
You put the owl weight on the first pan.

>[3] put snake weight on second pan
You put the snake weight on the second pan.

>[4] put sword weight on third pan
You put the sword weight on the third pan.

>[5] put shield weight on 4th pan
You put the shield weight on the fourth pan.

>[6] put spear weight on 5th pan
You put the spear weight on the fifth pan.

>[7] put horse on 6th pan
You put the horse weight on the sixth pan.

>x gate
The gate is now unlocked.

It seems to be locked.

>x gate
The gate is now unlocked.

It seems to be locked.

* * *

>test me
>--> The following tests are available:
'test cad'
'test gate'
'test pos'
'test art'
'test solutionsg'
'test sg2'

>go in door
You can't see any such thing.

>go in gate
Divine Cell 4
You see the gods sleeping

You can see a puzzle gate, Aphrodite and Hephaestus here.

>x gate
The puzzle gate is tightly closed.

* * *

>test me
>--> The following tests are available:
'test cad'
'test gate'
'test pos'
'test art'
'test solutionsg'
'test sg2'

>go in gate
(first opening the puzzle gate)
It isn't something you can open.

>go in gate
Secret Garden
You are in the Secret Garden

You find yourself before a beautiful flowerbed with vibrant red flowers.

You find yourself before a beautiful flowerbed with vibrant purple flowers.

You find yourself before a beautiful flowerbed with vibrant yellow flowers.

You find yourself before a beautiful flowerbed with vibrant white flowers.

You can also see a puzzle gate, a statue, a container B (in which is a purple flower), a container C (in which is a yellow flower) and a container D (in which is a white flower) here.

>x gate
The puzzle gate is tightly closed.

* * *

>test me
>--> The following tests are available:
'test cad'
'test gate'
'test pos'
'test art'
'test solutionsg'
'test sg2'

>go w
Secret Garden
You are in the Secret Garden

You find yourself before a beautiful flowerbed with vibrant red flowers.

You find yourself before a beautiful flowerbed with vibrant purple flowers.

You find yourself before a beautiful flowerbed with vibrant yellow flowers.

You find yourself before a beautiful flowerbed with vibrant white flowers.

You can also see a puzzle gate, a statue, a container B (in which is a purple flower), a container C (in which is a yellow flower) and a container D (in which is a white flower) here.

>show me
(the red flower)
This is an Adonis Flower.

>show me all
(the red flower)
This is an Adonis Flower.

* * *

>test me
>--> The following tests are available:
'test cad'
'test gate'
'test pos'
'test art'
'test solutionsg'
'test sg2'

>open gate
It isn't something you can open.

>take red flower from hands
You picked up a red flower.

You hear the sound of the gate closing.

>x gate
The puzzle gate is tightly closed.

>look
Secret Garden
You are in the Secret Garden

You find yourself before a beautiful flowerbed with vibrant red flowers.

You find yourself before a beautiful flowerbed with vibrant purple flowers.

You find yourself before a beautiful flowerbed with vibrant yellow flowers.

You find yourself before a beautiful flowerbed with vibrant white flowers.

You can also see a puzzle gate, a statue, a container B (in which is a purple flower), a container C (in which is a yellow flower) and a container D (in which is a white flower) here.

>x hands
The hands is empty.

>x gate
The puzzle gate is tightly closed.

>put red flower in arms
You can't see any such thing.

>put red flower in hands
You put the red flower into the hands.

You hear the sound of the gate opening

I beg your pardon?

>take red flower from hands
You picked up a red flower.

You hear the sound of the gate closing.

* * *

>test me
>--> The following tests are available:
'test cad'
'test gate'
'test pos'
'test art'
'test solutionsg'
'test sg2'

>test 1
(Testing.)

>[1] put red flower in hand
You place the red flower in the statue's right hand.

>[2] put purple flower in conch shell
(first taking the purple flower)
You picked up a purple flower.

You put the purple flower into the conch shell.

>[3] put yellow flower in shiny amphora
(first taking the yellow flower)
You picked up a yellow flower.

You put the yellow flower into the shiny amphora.

>[4] put white flower in tree cavity
(first taking the white flower)
You picked up a white flower.

You put the white flower into the tree cavity.

You hear the sound of the gate opening

>go in gate
Divine Cell 4
You see the gods sleeping

You see a lake. On its shore you see some seashells.

 The puzzle door from before is behind you

You can also see Aphrodite and Hephaestus here.

* * *

>test me
>--> The following tests are available:
'test cad'
'test gate'
'test pos'
'test art'
'test solutionsg'
'test sg2'

>w
Secret Garden
You are in the Secret Garden

You find yourself before a beautiful flowerbed with vibrant red flowers.

You find yourself before a beautiful flowerbed with vibrant purple flowers.

You find yourself before a beautiful flowerbed with vibrant yellow flowers.

You find yourself before a beautiful flowerbed with vibrant white flowers.

You can also see a puzzle gate, a statue, a container B (in which is a purple flower), a container C (in which is a yellow flower) and a container D (in which is a white flower) here.

>x hands
In the hands is a red flower.

>x gate
The puzzle gate is now unlocked.

>open gate
You open the puzzle gate.

>open gate
That's already open.

>close gate
You close the puzzle gate.

>take red flower from hand
You can't see any such thing.

>take red flower from hands
You picked up a red flower.

>x gate
The puzzle gate is locked.

* * *

>test me
>--> The following tests are available:
'test cad'
'test gate'
'test pos'
'test art'
'test solutionsg'
'test sg2'

>wait untill midday
I only understood you as far as wanting to wait.

* * *

>take sun key
You picked up a sun key.

>put key in sun lock
You put the sun key in the sun-shapped lock.

You put the sun key into the sun lock.

>wait until midnight
At ten past twelve you hear the sound of the sun hatch closing.

It is twelve o'clock now.

At twelve o'clock you hear the sound of a flap opening on the dial.

* * *

>take moon key
You picked up a moon key.

>put moon key in moon lock
You put the moon key in the moon-shapped lock.

You put the moon key into the moon lock.

You hear the sound of a locking mechanism unlocking.

>open the statue
You push the statue away and you reveal some stairs leading under the temple.

>go downstairs
You can't see any such thing.

>go down
You take the stairs that lead under the temple.

Divine Cell of Artemis & Apollo
You can see a Goddess Artemis and a God Apollo here.

* * *

>test me
>--> The following tests are available:
'test cad'
'test gate'
'test pos'
'test art'
'test solutionsg'
'test sg2'

>x gate
The puzzle gate is now open.

>go in gate
Divine Cell 4
You see the gods sleeping

You see a lake. On its shore you see some seashells.

A heavy looking gate that seems to lead to the next room is on the eastern side of the garden, its view obstructed by vines and flowers.

You can also see Aphrodite and Hephaestus here.

>x gate
The puzzle gate is now open.

>go in gate
Secret Garden
You are in the Secret Garden

You see a lake. On its shore you see some seashells.

A heavy looking gate that seems to lead to the next room is on the eastern side of the garden, its view obstructed by vines and flowers.

In the garden you see a statue of a beautiful man.

You can also see a container C (in which is a yellow flower) and a container D (in which is a white flower) here.

>i
You are carrying:
  an aria

* * *

>x gate
The puzzle gate is now open.

>put a red flower in the hands
You put the red flower into the hands.

You hear the sound of the gate opening

>go in gate
Divine Cell 4
You see the gods sleeping

You can see a puzzle gate, Aphrodite and Hephaestus here.

* * *

>x gate
The puzzle gate is now open.

>w
(first opening the puzzle gate)
It isn't something you can open.

* * *

>e
You can't go that way.

>put red flower in hands
You can't see any such thing.

* * *

>test pos
(Testing.)

>[1] rotate the top ring anticlockwise
Now its face shows spring.

>[2] rotate the second ring anticlockwise
Now its face shows spring.

>[3] rotate the second ring anticlockwise
Now its face shows summer.

>[4] rotate the third ring anticlockwise
Now its face shows spring.

>[5] rotate the third ring anticlockwise
Now its face shows summer.

>[6] rotate the third ring anticlockwise
Now its face shows fall.

>[7] rotate the bottom ring anticlockwise
Now its face shows spring.

>[8] rotate the bottom ring anticlockwise
Now its face shows summer.

>[9] rotate the bottom ring anticlockwise
Now its face shows fall.

>[10] rotate the bottom ring anticlockwise
Now its face shows winter.

You hear the sound of the door opening

>go in door
Divine Cell 2
You see the gods.

You can see a temple door, Poseidon and Demeter here.

>u
Poseidon's Temple
You see a coloumn with 4 rotatable discs. The discs have 5 faces, 4 of them with a picture and one empty. The pictures are the same on each disc and they are in order: Budding olives and fresh green leaves, Green olives growing in size, with fuller leaves, Ripe, darkening olives ready for harvest, some fallen to the ground and Bare branches with a few remaining leaves, the tree in a state of dormancy. The faces towards the altar are all empty.

Altar.

Column that faces the altar.

On the column are top ring, second ring, third ring and bottom ring.

You can also see a temple door here.

>d
Divine Cell 2
You see the gods.

You can see a temple door, Poseidon and Demeter here.

* * *

>x door
The gate is now open.

* * *

>test solutionSG
(Testing.)

>[1] put red flower in hand
You place the red flower in the statue's right hand.

>[2] put purple flower in conch shell
(first taking the purple flower)
You picked up a purple flower.

You put the purple flower into the conch shell.

>[3] put yellow flower in amphora on the right
(first taking the yellow flower)
You picked up a yellow flower.

You put the yellow flower into the amphora on the right.

>[4] put white flower in tree cavity
(first taking the white flower)
You picked up a white flower.

You put the white flower into the tree cavity.

You hear the sound of the gate opening

>enter gate
Divine Cell 4
devine cell 4 description TODO

>enter gate
Secret Garden
You find yourself in the Secret Garden, a vibrant haven where nature's palette is on full display. Four flowerbeds burst with color: red, purple, yellow, and white, each a riot of blossoms. To your right, a row of golden amphorae, exuding a sweet, intoxicating perfume, gleams in the sunlight. At the garden's heart stands an enormous willow tree, its ancient trunk hollowed by time, providing a natural cavity within its embrace. Beneath its sprawling branches lies a serene lake, its shore full with delicate sea shells. On the eastern edge of the garden, a heavy gate that seems to lead to the next room, though its form is almost hidden by a tangle of vines and blooms. Nearby, a statue of a strikingly beautiful man stands as if guarding the garden's secrets.

>x supporter
You can't see any such thing.

* * *

>testme
That's not a verb I recognise.

>test
>--> The following tests are available:
'test pos'
'test solutionsg'
'test sg2'

>test pos
(Testing.)

>[1] rotate the top ring clockwise
Now its face shows winter.

>[2] rotate the second ring clockwise 2 times
I only understood you as far as wanting to rotate second ring.

>[3] rotate the third ring clockwise 3 times
I only understood you as far as wanting to rotate third ring.

>[4] rotate the bottom ring clockwise 4 times
I only understood you as far as wanting to rotate bottom ring.

>rotate the second ring
Nothing obvious happens.

>rotate the second ring clockwise
Now its face shows winter.

>rotate the second ring clockwise
Now its face shows fall.

>rotate the second ring clockwise
Now its face shows summer.

>rotate the third ring clockwise
Now its face shows winter.

>rotate the third ring anticlockwise
Now its face shows blank.

>rotate the third ring clockwise
Now its face shows winter.

>rotate the third ring clockwise
Now its face shows fall.

>rotate the bottom ring clockwise
Now its face shows winter.

>showme
Poseidon's Temple - room
    sea - closed door
    temple door - closed door
    yourself - woman
    altar
    column - supporter
        top ring - ring
        second ring - ring
        third ring - ring
        bottom ring - ring

>showme top ring
top ring - ring
location: on the column in the Poseidon's Temple
unlit, inedible, portable; singular-named, proper-named
description: none
initial appearance: none
ring face: winter
printed name: "top ring"
printed plural name: "rings"
indefinite article: none
list grouping key: none

>rotate the top ring clockwise
Now its face shows fall.

>rotate the top ring clockwise
Now its face shows summer.

>rotate the top ring clockwise
Now its face shows spring.

You hear the sound of the door opening

>go in door
Divine Cell 2
You see the gods.

You can see a temple door, Poseidon and Demeter here.

* * *

>travel to aulis
You travel to the Gates of Aulis.

Gates of Aulis

>s
You can't go that way.

>n
Agora of Aulis

>e
Port of Aulis
TODO: Aulis port Description

* * *

>travel to aulis
You travel to the Gates of Aulis.

Gates of Aulis

>travel to olympus
You travel to the Foothills of Mount Olympus.

Foothills of Mount Olympus
Mountain Olympus Hall Description

>go up
Hall of Mount Olympus

>d
Foothills of Mount Olympus
Mountain Olympus Hall Description

* * *

>travel to delphi
You travel to the Gates of Delphi.

Gates of Delphi
From here you can travel to: 
→ Thebes
→ Aulis
→ Athens
→ Ephyra
→ Mount Olympus

>travel to mount olympus
You travel to the Foothills of Mount Olympus.

Foothills of Mount Olympus
Mountain Olympus Hall Description

>go e
You can't go that way.

>go e
You can't go that way.

>go w
You can't go that way.

>go n
You can't go that way.

>go s
You can't go that way.

>u
Hall of Mount Olympus

>d
Foothills of Mount Olympus
Mountain Olympus Hall Description

>travel to delphi
You travel to the Gates of Delphi.

Gates of Delphi
From here you can travel to: 
→ Thebes
→ Aulis
→ Athens
→ Ephyra
→ Mount Olympus

* * *

>travel to ephyra
You travel to the Gates of Ephyra.

Gates of Ephyra
From here you can travel to: 
→ Mount Olympus 
→ Athens
→ Thebes
→ Aulis
→ Delphi

>e
East of Ephyra

>go in acheron river
You went into the acheron river
Acheron River
Acheron River.

>d
Elysial Fields

>d
Asphodel Meadows

>d
Tartarus

>d
You can't go that way.

* * *

>travel to mount olympus
You travel to the Foothills of Mount Olympus.

Foothills of Mount Olympus
From here you can travel to: 
→ Ephyra 
→ Athens
→ Thebes
→ Aulis
→ Delphi

>travel to ephyra
You travel to the Gates of Ephyra.

Gates of Ephyra
From here you can travel to: 
→ Mount Olympus 
→ Athens
→ Thebes
→ Aulis
→ Delphi

>travel to aulis
You travel to the Gates of Aulis.

Gates of Aulis
From here you can travel to: 
→ Thebes
→ Athens
→  Delphi
→ Ephyra
→ Mount Olympus

* * *

>s
You can't go that way.

>w
You can't go that way.

* * *

>n
Agora of Aulis

>e
Port of Aulis
From here you can sail to: 
→ Sounio
→ Garden of Hesperides

>travel to garden of hesperides
That noun did not make sense in this context.

>travel to the garden of hesperides
That noun did not make sense in this context.

>sail to garden of hesperides
You sail to the Garden of Hesperides.

Garden of Hesperides
You can see Aigle, Arethousa, Erytheia and Hesperie here.

>sail to paphos
You sail to the Port of Paphos.

Port of Paphos
The main port of the city of Paphos. 

From here you can sail to: 
→ Athens
→ Garden of Hesperides

>sail to athens
That noun did not make sense in this context.

>sail to piraeus
You sail to the Port of Piraeus.

Port of Piraeus
From here you can sail to: 
→ Paphos
→ Garden of Hesperides

>n
You can't go that way.

>ne
Agora of Athens

* * *

>se
Southern Gates of Athens
From here you can travel to: 
→ Sounio

>travel to sounio
You travel to the Gates of Sounio.

Gates of Sounio
From here you can travel to: 
→ Athens

>s
Agora of Sounio

>e
Sounio Beach
Description of Sounio beach. You see some nereides fighting. Poseidon's temple is in the sea.

You can see some nereides, Aktaia, Erato, Ploto and an angry nereida here.

>e
You can't go that way.

* * *

>n
You can't go that way.

>s
The nereides agree to take you to the sunken Temple.

Poseidon's Temple
You see a coloumn with 4 rotatable discs. The discs have 5 faces, 4 of them with a picture and one empty. The pictures are the same on each disc and they are in order: Budding olives and fresh green leaves, Green olives growing in size, with fuller leaves, Ripe, darkening olives ready for harvest, some fallen to the ground and Bare branches with a few remaining leaves, the tree in a state of dormancy. The faces towards the altar are all empty.

Altar.

Column that faces the altar.

On the column are top ring, second ring, third ring and bottom ring.

You can also see a temple door here.

* * *

>travel to thebes
You travel to the Gates of Thebes.

Gates of Thebes

>travel to aulis
You travel to the Gates of Aulis.

Gates of Aulis

* * *

>travel to olympus
You travel to the Foothills of Mount Olympus.

Foothills of Mount Olympus
Mountain Olympus Hall Description

>travel to athens
Which do you mean, Northen Gates of Athens or Southern Gates of Athens?

>northen
You travel to the Northen Gates of Athens.

Northen Gates of Athens

>s
Agora of Athens

* * *

>sw
Port of Piraeus
TODO: Pireaus Description (where the player can go?)

>sail to paphos
You sail to the Port of Paphos.

Port of Paphos
The main port of the city of Paphos. From here you can travel abroad.

* * *

>travel to thebes gates
Gates of Thebes
You travel to Gates of Thebes.

>travel to Northen Gates of Athens
Northen Gates of Athens
You travel to Northen Gates of Athens.

>travel to port of paphos
You cannot travel directly to the Port of Paphos from here.

* * *

>travel to thebes gates
Gates of Thebes
You travel to Gates of Thebes.

>travel to athens
Which do you mean, Northen Gates of Athens or Southern Gates of Athens?

>travel to aulis
Which do you mean, Port of Aulis or Gates of Aulis?

>travel to delphi
Gates of Delphi
You travel to Gates of Delphi.

* * *

>u
Throne Room
Home to the King of Paphos, Cinyras. Down is the Secret Garden.

You can see Cinyras here.

>d
Secret Garden
You find yourself in the Secret Garden, a vibrant haven where nature's palette is on full display. Four flowerbeds burst with color: red, purple, yellow, and white, each a riot of blossoms. To your right, a row of golden amphorae, exuding a sweet, intoxicating perfume, gleams in the sunlight. At the garden's heart stands an enormous willow tree, its ancient trunk hollowed by time, providing a natural cavity within its embrace. Beneath its sprawling branches lies a serene lake, its shore full with delicate sea shells. On the eastern edge of the garden, a heavy gate that seems to lead to the next room, though its form is almost hidden by a tangle of vines and blooms. Nearby, a statue of a strikingly beautiful man stands as if guarding the garden's secrets.

>w
You can't go that way.

* * *

>d
You can't go that way.

>e
(first opening the flower gate)
It isn't something you can open.

>x red flowerbed
You can see some red flowers in this flowerbed.

>x container
(the hand)
You notice the number Α carved on its index finger.
It's not holding anything

>x containers
(the hand)
You notice the number Α carved on its index finger.
It's not holding anything

* * *

>u
Throne Room
Home to the King of Paphos, Cinyras. Down is the Secret Garden.

You can see Cinyras here.

>s
Outside of the Palace of Paphos

>e
You can't go that way.

* * *

>w
You can't go that way.

>s
Agora of Paphos
The main square of Paphos. You can see the Palace of Paphos on the north.

* * *

>u
Throne Room
Home to the King of Paphos, Cinyras. Down is the Secret Garden.

You can see Cinyras here.

>u
You can't go that way.

>u
You can't go that way.

Olympus Hall Celebration Scene ended

* * *

>unlock dvdoor
unlocking the door

* * *

>unlock statue
It seems like you need 2 keys for the locks to unlock.

>wait until midday
It is twelve o'clock now.

At twelve o'clock you hear the sound of a hatch opening on the dial.

>put sun key in sun lock
You put the sun key in the sun-shapped lock.

(first taking the sun key)
You picked up a sun key.

You put the sun key into the sun lock.

>unlock statue
It seems like you need 2 keys for the locks to unlock.

>take moon key
Which do you mean, the moon lock or the moon pocket?

>take key
You picked up a sun key.

>unlock moon lock
You need a matching moon key for this lock.

* * *

>unlock sun lock
You need a matching key for this lock.

>showme sun lock
sun lock - open container
location: part of the statue of artemis in the Temple of the Aulidean Artemis
unlit, inedible, fixed in place; opaque, open, unopenable, unlocked; singular-named, improper-named
description: none
initial appearance: none
carrying capacity: 100
printed name: "sun lock"
printed plural name: "containers"
indefinite article: none
list grouping key: none

>unlock sun lock with sun key
You can't see any such thing.

* * *

>unlock sun lock
You need a matching key for this lock.

>showme sunlock
There seems to be no such object anywhere in the model world.

>showme sun lock
sun lock - open container
location: part of the statue of artemis in the Temple of the Aulidean Artemis
unlit, inedible, fixed in place; opaque, open, unopenable, unlocked; singular-named, improper-named
description: none
initial appearance: none
carrying capacity: 100
printed name: "sun lock"
printed plural name: "containers"
indefinite article: none
list grouping key: none

* * *

>unlock sun lock
You need a matching key for this lock.

>unlock statue
It seems like you need 2 keys for this door to unlock.

* * *

>unlock the dvdoor with sunkey
You can't see any such thing.

>unlock the dvdoor with sun key
(first taking the sun key)
You picked up a sun key.

It seems like you need 2 keys for this door to unlock.

>i
You are carrying:
  a sun key

>>unlock the dvdoor with moon key
That's not a verb I recognise.

>unlock the dvdoor with moon key
(first taking the moon key)
You picked up a moon key.

You inserted both keys into their respective lock.

You hear the sound of the gate mechanism unlocking

>go in dvdoor
(first opening the dvdoor)

Divine Cell of Artemis & Apollo
You can see one sun lock and one moon lock on the door.

You can also see a Goddess Artemis and a God Apollo here.

* * *

>w
You can't go that way.

>nw
Gates of Thebes

>w
Gates of Delphi

* * *

>nw
Gates of Ephyra

>se
Gates of Delphi

* * *

>w
You can't go that way.

>w
Throne Room
Home to the King of Paphos, Pygmalion.

You can see Cinyras here.

* * *

>d
Secret Garden
You see many flowers

Red Flowers

You can also see some Amaranths, a statue and a sign here.

>examine red flowers
You can't see any such thing.

>examine red flower
You see nothing special about Adonis.

* * *

>wait
Time passes.
Would you maybe prefer waiting until a certain time?

>wait
Time passes.

>x sun dial
You can't see any such thing.

>x sundial
Judging by the shadow and the markings, the time is nine o'clock.

>wait
Time passes.

>wait
Time passes.

>wait more
I only understood you as far as wanting to wait.

* * *

>wait
Time passes.
Would you maybe prefer waiting until a certain time?

>wait until 12
It is 12:00 pm now.

You notice that the sun pocket open.

You hear the sound of the sun pocket opening.

* * *

>wait 12 hours
At twelve o'clock  you hear the click of a latch releasing and a sun hatch opening coming from the dial.

At ten past twelve you hear the sound of the sun hatch closing and the click of a latch locking coming from the dial.

It is now around nine o'clock

>wait 12 hours
The day passes and a new day is dawing...

At twelve o'clock you hear the click of a latch releasing and a moon hatch opening coming from the dial.

At ten past twelve you hear the sound of the moon hatch closing and the click of a latch locking coming from the dial.

It is now around nine o'clock

>sleep
You slept until morning.

>wait 12 hours
At twelve o'clock  you hear the click of a latch releasing and a sun hatch opening coming from the dial.

At ten past twelve you hear the sound of the sun hatch closing and the click of a latch locking coming from the dial.

It is now around nine o'clock

>wait 3 hours
The day passes and a new day is dawing...

At twelve o'clock you hear the click of a latch releasing and a moon hatch opening coming from the dial.

It is now around twelve o'clock

* * *

>wait 12 hours
The day passes and a new day is dawing...

At twelve o'clock you hear the click of a latch releasing and a moon hatch opening coming from the dial.

At ten past twelve you hear the sound of the moon hatch closing and the click of a latch locking coming from the dial.

It is now around nine o'clock

>wait 12 hours
At twelve o'clock  you hear the click of a latch releasing and a sun hatch opening coming from the dial.

At ten past twelve you hear the sound of the sun hatch closing and the click of a latch locking coming from the dial.

It is now around nine o'clock

>get out
Agora of Aulis

>wait 12 hours
At twelve o'clock you hear the click of a latch releasing and a moon hatch opening coming from the dial.

At ten past twelve you hear the sound of the moon hatch closing and the click of a latch locking coming from the dial.

It is now around nine o'clock

* * *

>wait 3 hours
It is now around early morning

At twelve o'clock  you hear the click of a latch releasing and a sun hatch opening coming from the dial.

>x dial
(the sundial)
The dial is designed with two separate rings encircling its plate, one with sun and one with lunar markings, allowing you to read the time day and night. You also see on the gnomon an inscription engraved and gilded in gold that says: At midday, let Apollo's light cast a shadow, and at midnight, let Artemis' glow guide the way. Only then shall the twins unveil the hidden path.

Judging by the gnomon's shadow and the sun markings, the time is twelve o'clock.

>wait 5 hours
At ten past twelve you hear the sound of the sun hatch closing and the click of a latch locking coming from the dial.

It is now around early morning

* * *

>wait for 4 rounds
I only understood you as far as wanting to wait.

>wait 3 times
I only understood you as far as wanting to wait.

* * *

>wait for 5 turns
Time passes.

Time passes.

Time passes.

Time passes.

Time passes.

>x sundial
Judging by the shadow and the markings, the time is nine o'clock.

>wait for 40 turns
Time passes.

Time passes.

Time passes.

Time passes.

Time passes.

Time passes.

Time passes.

Time passes.

Time passes.

Time passes.

Time passes.

Time passes.

Time passes.

Time passes.

Time passes.

Time passes.

Time passes.

Time passes.

Time passes.

Time passes.

Time passes.

Time passes.

Time passes.

Time passes.

Time passes.

Time passes.

Time passes.

Time passes.

Time passes.

Time passes.

Time passes.

Time passes.

Time passes.

Time passes.

Time passes.

Time passes.

Time passes.

Time passes.

Time passes.

Time passes.

>x sundial
Judging by the shadow and the markings, the time is nine o'clock.

* * *

>wait
Time passes.

>x sundial
Judging by the shadow and the markings, the time is ten past nine.

>wait for 3 turns
Time passes.

Time passes.

Time passes.

>x sundial
Judging by the shadow and the markings, the time is ten past nine.

>wait for 10 turns
Time passes.

Time passes.

Time passes.

Time passes.

Time passes.

Time passes.

Time passes.

Time passes.

Time passes.

Time passes.

>x sundial
Judging by the shadow and the markings, the time is ten past nine.

* * *

>wait midday
I only understood you as far as wanting to wait.

>wait until midday
It is twelve o'clock now.

At twelve o'clock  you hear the click of a latch releasing and a sun hatch opening coming from the dial.

>examine sun hatch
The sun hatch is open. Inside you can see a sun key.

>take sun key
You picked up a sun key.

>wait until midnight
At ten past twelve you hear the sound of the sun hatch closing and the click of a latch locking coming from the dial.

It is twelve o'clock now.

At twelve o'clock you hear the click of a latch releasing and a moon hatch opening coming from the dial.

>examine hatch
You can't see any such thing.

>examine moon hatch
The moon hatch is open. Inside you can see a moon key.

>take key
(the moon key)
You picked up a moon key.

>examine room
You can't see any such thing.

>look
Temple of the Aulidean Artemis
Inside the Temple of the Aulidean Artemis you can see a sundial, the statue of Artemis and her sacrificial altar.

>examine statue
On the base of the statue you can see two locks: one sun-shapped and one moon-shapped.

>put moon key
What do you want to put the moon key in?

>moon shapped lock
You can't see any such thing.

>put moon key in moon shapped lock
You can't see any such thing.

>put moon key in lock
Which do you mean, the sun lock or the moon lock?

>moon
You put the moon key in the moon-shapped lock.

You put the moon key into the moon lock.

>put sun key in lock
Which do you mean, the sun lock or the moon lock?

>sun
You put the sun key in the sun-shapped lock.

You put the sun key into the sun lock.

You hear the sound of a locking mechanism unlocking.

>look
Temple of the Aulidean Artemis
Inside the Temple of the Aulidean Artemis you can see a sundial, the statue of Artemis and her sacrificial altar.

>examine statue
The statue feels wobbly. Maybe you could try pushing it...

>push statue
You push the statue away and you reveal some stairs leading under the temple.

>help
That's not a verb I recognise.

>examine stairs
You can't see any such thing.

>take the stairs
You can't see any such thing.

>eat stairs
You can't see any such thing.

>go down staits
I only understood you as far as wanting to go down.

>go down stairs
I only understood you as far as wanting to go down.

>smell stairs
You can't see any such thing.

>smell deer
It smells neutral.

At ten past twelve you hear the sound of the moon hatch closing and the click of a latch locking coming from the dial.

>smell statue
It smells neutral.

>smell stairs
You can't see any such thing.

>smell Artemis
It smells neutral.

* * *

>wait until 10 pm
You hear the sound of the sun pocket opening.

You hear the sound of the sun pocket closing.

It is ten o'clock now.

>l
Temple of the Aulidean Artemis
You walk inside the Temple of Aulidean Artemis. First you observe the pronaos room. Moonlight shines from the open ceilingIn it you can see a big sundial in the middle of the room, light from above shining on it.

You can see one sun lock and one moon lock on the door.

You can also see a sundial here.

* * *

>wait until 9 pm
At twelve o'clock you hear the sound of the sun pocket opening.

At ten past twelve you hear the sound of the sun pocket closing.

It is nine o'clock now.

>l
Temple of the Aulidean Artemis
 You step into the sacred Temple of Aulidean Artemis, where the scent of incense and ancient prayers is still fresh, despite the absence of the priestesses. As you pass through the pronaos, your eyes are drawn to the moonlight cascading down from the open ceiling, illuminating an imposing sundial that stands ar the center of the chamber. The moon's rays trace their path across the dial, a silent testament to the passing hours in this eternal sanctuary.

Entering the naos, the very heart of the temple, you find yourself in the presence of the magnificent golden statue of Artemis. My sister stands tall and proud, her form aglow with a divine radiance that speaks of her unyielding strength and purity. In her left hand, she holds the antlers of a noble deer, symbolizing her dominion over the wild, while her right hand grips her bow, ever ready to protect those who dwell under her watchful eye. A quiver, filled with finely crafted arrows, rests upon her back, the tools of the huntress who lets no prey escape.

At her feet, the altar of Artemis beckons, a place where mortals have laid their offerings, hoping to earn her favor.

* * *

>wait until 9:30
It is half past nine now.

>x sundial
Judging by the shadow and the markings, the time is half past nine.

>x sunpocket
You can't see any such thing.

>x sun pocket
The sun pocket is closed.

>wait until 12 pm
It is twelve o'clock now.

You hear the sound of the sun pocket opening.

>wait until 12:10
It is ten past twelve now.

You hear the sound of the sun pocket closing.

>x sundial
Judging by the shadow and the markings, the time is ten past twelve.

* * *

>wait until miday
I only understood you as far as wanting to wait.

>wait until midday
It is twelve o'clock now.

At twelve o'clock you hear the sound of the sun pocket opening.

>x sun pocket
The sun pocket is open. Inside you can see a sun key.

* * *

>wait until midday
It is twelve o'clock now.

At twelve o'clock you hear the click of a latch releasing and a hatch opening coming from the dial.

>take sun key
You picked up a sun key.

>unlock sun lock with sun key
You put the sun key in the sun-shapped lock.

* * *

>x
What do you want to examine?

>room
You can't see any such thing.

>l
Secret Garden
You are in the Secret Garden

You find yourself before a beautiful flowerbed with vibrant red flowers.

You find yourself before a beautiful flowerbed with vibrant purple flowers.

You can also see a statue and a sign here.

>x flowerbed
Which do you mean, the red flowerbed or the purple flowerbed?

>x red flowerbed
You can see some red flowers in this flowerbed

In the red flowerbed are ten red flowers and ten purple flowers.

>x red flowers
You can't use multiple objects with that verb.

>x red flower
This is an Adonis Flower.

>x purple flower
This is an Amaranthos Flower.

>take flowerbeds
Which do you mean, the red flowerbed or the purple flowerbed?

>botj
You can't see any such thing.

>take red flowerbed
That's fixed in place.

>take purple flowerbed
That's fixed in place.

>unfix purple flowerbed
That's not a verb I recognise.

>unscrew purple flowerbed
It is fixed in place.

>take it anyway
I only understood you as far as wanting to take the purple flowerbed.

>l
Secret Garden
You are in the Secret Garden

You find yourself before a beautiful flowerbed with vibrant red flowers.

You find yourself before a beautiful flowerbed with vibrant purple flowers.

You can also see a statue and a sign here.

>read sign
The sign is made of marble. The inscription on it reads: Painful memories of our love surround this place.

>take sign
That's fixed in place.

>cut sign
Cutting it up would achieve little.

>break sign
Violence isn't the answer to this one.

>clear
What do you want to clear?

>sign
It is fixed in place.

>clear purple flowers
You can't use multiple objects with that verb.

>clear 1 purple flower
Nothing obvious happens.

>take purple flowers
purple flower: That was the last red flower. There are no more in this garden.
purple flower: That was the last red flower. There are no more in this garden.
purple flower: That was the last red flower. There are no more in this garden.
purple flower: That was the last red flower. There are no more in this garden.
purple flower: That was the last red flower. There are no more in this garden.
purple flower: That was the last red flower. There are no more in this garden.
purple flower: That was the last red flower. There are no more in this garden.
purple flower: That was the last red flower. There are no more in this garden.
purple flower: That was the last red flower. There are no more in this garden.
purple flower: That was the last red flower. There are no more in this garden.

>put purple flowers in red flowerbed
purple flower: Done.
purple flower: Done.
purple flower: Done.
purple flower: Done.
purple flower: Done.
purple flower: Done.
purple flower: Done.
purple flower: Done.
purple flower: Done.
purple flower: Done.

>i
You are carrying nothing.

>take purple flowers
purple flower: That was the last red flower. There are no more in this garden.
purple flower: That was the last red flower. There are no more in this garden.
purple flower: That was the last red flower. There are no more in this garden.
purple flower: That was the last red flower. There are no more in this garden.
purple flower: That was the last red flower. There are no more in this garden.
purple flower: That was the last red flower. There are no more in this garden.
purple flower: That was the last red flower. There are no more in this garden.
purple flower: That was the last red flower. There are no more in this garden.
purple flower: That was the last red flower. There are no more in this garden.
purple flower: That was the last red flower. There are no more in this garden.

>i
You are carrying:
  ten purple flowers

>put purple flowers in red flowerbed
purple flower: Done.
purple flower: Done.
purple flower: Done.
purple flower: Done.
purple flower: Done.
purple flower: Done.
purple flower: Done.
purple flower: Done.
purple flower: Done.
purple flower: Done.

>x red flowerbed
You can see some red flowers in this flowerbed

In the red flowerbed are ten purple flowers and ten red flowers.

>x red flowerbed
You can see some red flowers in this flowerbed

In the red flowerbed are ten purple flowers and ten red flowers.

>l
Secret Garden
You are in the Secret Garden

You find yourself before a beautiful flowerbed with vibrant red flowers.

You find yourself before a beautiful flowerbed with vibrant purple flowers.

You can also see a statue and a sign here.

>x statue
The statue depicts a beautiful man. He's holding a basket.  It is empty.

>take basket
That seems to be a part of the statue.

>take flowers
purple flower: That was the last red flower. There are no more in this garden.
purple flower: That was the last red flower. There are no more in this garden.
purple flower: That was the last red flower. There are no more in this garden.
purple flower: That was the last red flower. There are no more in this garden.
purple flower: That was the last red flower. There are no more in this garden.
purple flower: That was the last red flower. There are no more in this garden.
purple flower: That was the last red flower. There are no more in this garden.
purple flower: That was the last red flower. There are no more in this garden.
purple flower: That was the last red flower. There are no more in this garden.
purple flower: That was the last red flower. There are no more in this garden.
red flower: You picked up a red flower.
red flower: You picked up a red flower.
red flower: You picked up a red flower.
red flower: You picked up a red flower.
red flower: You picked up a red flower.
red flower: You picked up a red flower.
red flower: You picked up a red flower.
red flower: You picked up a red flower.
red flower: You picked up a red flower.
red flower: That was the last red flower. There are no more in this garden.

>i
You are carrying:
  ten red flowers
  ten purple flowers

>put flowers in statue
red flower: That can't contain things.
red flower: That can't contain things.
red flower: That can't contain things.
red flower: That can't contain things.
red flower: That can't contain things.
red flower: That can't contain things.
red flower: That can't contain things.
red flower: That can't contain things.
red flower: That can't contain things.
red flower: That can't contain things.
purple flower: That can't contain things.
purple flower: That can't contain things.
purple flower: That can't contain things.
purple flower: That can't contain things.
purple flower: That can't contain things.
purple flower: That can't contain things.
purple flower: That can't contain things.
purple flower: That can't contain things.
purple flower: That can't contain things.
purple flower: That can't contain things.

>put flowers in basket
red flower: Done.
red flower: Done.
red flower: Done.
red flower: Done.
red flower: Done.
red flower: Done.
red flower: Done.
red flower: Done.
red flower: Done.
red flower: Done.
purple flower: Done.
purple flower: Done.
purple flower: Done.
purple flower: Done.
purple flower: Done.
purple flower: Done.
purple flower: Done.
purple flower: Done.
purple flower: Done.
purple flower: Done.

>x statue
The statue depicts a beautiful man. He's holding a basket. It has red flowers inside.  It has purple flowers inside.

>clear stute
You can't see any such thing.

>clear statue
It is fixed in place.

>use sign to unfix statue
That's not a verb I recognise.

>dig sign
That's not a verb I recognise.

>dig
That's not a verb I recognise.

>excavate
That's not a verb I recognise.

>saw
That's not a verb I recognise.

>bake
That's not a verb I recognise.

>cook
That's not a verb I recognise.

>eat statue
That's plainly inedible.

>eat flowers
You can't use multiple objects with that verb.

>eat flower
Which do you mean, a purple flower or a red flower?

>red flower
That's plainly inedible.

>wait until night
I only understood you as far as wanting to wait.

>wait night
I only understood you as far as wanting to wait.

>wait
Time passes.

>w
You can't go that way.

>t
That's not a verb I recognise.

>time
That's not a verb I recognise.

>look time
You can't see any such thing.

>what time is it
That's not a verb I recognise.

>c
That's not a verb I recognise.

>clock
That's not a verb I recognise.

>su n
That's not a verb I recognise.

>sun
That's not a verb I recognise.

>look sun
You can't see any such thing.

>look sky
You can't see any such thing.

>uffa
That's not a verb I recognise.

>bite statue
That's not a verb I recognise.

>byte statue
That's not a verb I recognise.

>x purple flower
This is an Amaranthos Flower.

* * *

>x acheron river
You see nothing special about the Acheron River.

* * *

>x all torches
You can't use multiple objects with that verb.

>x all torch
You can't use multiple objects with that verb.

>x tutta torch
You can't see any such thing.

* * *

>x altar
The altar of Artemis.

>x sundial
You notice it has both sundial and moondial marks, so you can tell the time both with the help of the sun and the moon. You also see some words carved on its gnomon: At midday, let Apollo's light cast no shadow, and at midnight, let Artemis" glow guide the way. Only then shall the twins unveil the hidden path.

Judging by the gnomon's shadow and the sun markings, the time is nine o'clock.

>x statue
On the base of the statue you can see two locks: one sun-shapped and one moon-shapped.

* * *

>x amphitrite
her name is nereida.

* * *

>x artemis statue
On the base of the statue you can see two locks: one sun-shapped and one moon-shapped.

>x statue
On the base of the statue you can see two locks: one sun-shapped and one moon-shapped.

>x sundial
You notice it has both sundial and moondial marks, so you can tell the time both with the help of the sun and the moon. You also see some words carved on the gnomon: At midday, let Apollo's light cast no shadow, and at midnight, let Artemis" glow guide the way. Only then shall the twins unveil the hidden path.

Judging by the shadow and the markings, the time is nine o'clock.

>wait
Time passes.
Would you maybe prefer waiting until a certain time?

>wait until 3 pm
At twelve o'clock you hear the sound of the sun pocket opening.

At ten past twelve you hear the sound of the sun pocket closing.

It is three o'clock now.

* * *

>x base
You can't see any such thing.

>x base of statue
You can't see any such thing.

* * *

>x club
You see nothing special about the Heracles' Club.

* * *

>take club
You picked up a Heracles' Club.

>l
Mount Olympus Hall
You can see Heracles, Zeus, Hera, Demeter, Hestia, Poseidon, Aphrodite, Apollo, Artemis, Athena, Ares, Dionysus, Hephaestus and Hermes. Ganymedes is running around, serving nectar on request.

>give club to heracles
He smiles to you. "Thank you my dearest."

You give the Heracles' Club to the God Heracles.

>t
Suddenly, an eerie silence fell over the festive night. The singing and dancing ceased, as if an unseen hand had stilled them. For a brief moment, you felt the coldness of the mountain air, a stark contrast to the pleasant breeze that had enveloped you moments before. A sense of foreboding fills you as you become aware that all eyes are turned behind you. You lock eyes with Heracles, both of you sharing a look of worry. With a growing sense of dread, you turned to see what had drawn everyone's attention.

"Oh dear, please, do not let my presence taint your insignificant gathering. Carry on as you were."

The voice was unmistakable, deep and resonant, carrying an ancient power that sent shivers down your spine. It was Kronos. So much time has passed since our triumph in the War of Titans- the Titanomachy. How did he manage to escape Tartarus?

The sight of the Titan, towering and menacing, shrouded in shadows, struck fear into the hearts of all present. You start to feel the ambrosia in your divine veins turn cold, as if time itself had frozen. The gods, normally so mighty and formidable, stand paralyzed in shock. Nothing moves. In a heartbeat, you break free from the daze and come to your senses. Your next actions have never been more certain. It's now or never.

You grab Heracle's club out of his hands and leap towards Kronos. Then you feel yourself slipping into unconciousness.

>k
Garden of Hesperides
1-2 months timeskip. the nymphs tended to your wounds and restored you with nectar and ambrosia. They tell you what happened with the gods and send you towards the oracle of delphi.

From here you can sail to: 
→ Piraeus
→ Sounio
→ Aulis
→ Paphos

You can see Aigle, Arethousa, Erytheia and Hesperie here.

* * *

>x conch shells
I only understood you as far as wanting to examine the conch shell.

>x containers
(the hand)
You notice the number Α carved on its index finger.
It's not holding anything

>showme hand
hand - transparent open container
location: part of the statue in the Secret Garden
unlit, inedible, fixed in place; transparent, open, unopenable, unlocked; singular-named, improper-named
description: none
initial appearance: none
carrying capacity: 1
printed name: "hand"
printed plural name: "containers"
indefinite article: none
list grouping key: none

* * *

>x container
Which container do you mean? Please specify.

>go in gate
(first opening the flower gate)
It isn't something you can open.

>test
>--> The following tests are available:
'test getweights'
'test dragongate'
'test pos'
'test art'
'test fire'

>test pos
(Testing.)

>[1] rotate the top ring anticlockwise
You can't reach into the Poseidon's Temple.

>[2] rotate the second ring anticlockwise
You can't reach into the Poseidon's Temple.

>[3] rotate the second ring anticlockwise
You can't reach into the Poseidon's Temple.

>[4] rotate the third ring anticlockwise
You can't reach into the Poseidon's Temple.

>[5] rotate the third ring anticlockwise
You can't reach into the Poseidon's Temple.

>[6] rotate the third ring anticlockwise
You can't reach into the Poseidon's Temple.

>[7] rotate the bottom ring anticlockwise
You can't reach into the Poseidon's Temple.

>[8] rotate the bottom ring anticlockwise
You can't reach into the Poseidon's Temple.

>[9] rotate the bottom ring anticlockwise
You can't reach into the Poseidon's Temple.

>[10] rotate the bottom ring anticlockwise
You can't reach into the Poseidon's Temple.

>test art
(Testing.)

>[1] wait until 12 pm
I only understood you as far as wanting to wait.

>[2] take sun key
You can't see any such thing.

>[3] wait until 12 am
I only understood you as far as wanting to wait.

>[4] take moon key
You can't see any such thing.

>[5] put sun key in sun lock
You can't see any such thing.

>[6] put moon key in moon lock
You can't see any such thing.

* * *

>x containers
(the hand)
You notice the number Α carved on its index finger.
It's not holding anything

* * *

>x deer
You can't see any such thing.

* * *

>x empty scroll
An empty scroll. Smells citrusy.

>x elegant carpet
An elegant red carpet. When you step on it to inspect it further, you hear creaking.

>take carpet
That's called theft! Refer from it in the future.

* * *

>x flower
Which do you mean, a red flower, a purple flower or an orange flower?

* * *

>x flowerbeds
Which do you mean, the red flowerbed, the purple flowerbed or the orange flowerbed?

* * *

>x flowers
You can't use multiple objects with that verb.

>look flower
(the flower gate)
The gate is tightly closed.

>x lake
It's a beautiful lake full of pink and white water lilies sitting on its surface.

* * *

>x flowers
You can't use multiple objects with that verb.

>look flowers
You can't use multiple objects with that verb.

>look flower
(the flower gate)
The gate is tightly closed.

>take vines
You can't see any such thing.

* * *

>x gate
The gate is locked.

>o gate
Sorry, that can't be corrected.

>open gate
It isn't something you can open.

>enter gate
(first opening the puzzle gate)
It isn't something you can open.

>test me
(Testing.)

>[1] put red flower in hands
(first taking the red flower)
You picked up a red flower.

You put the red flower into the hands.

>[2] put purple flower in b
(first taking the purple flower)
You picked up a purple flower.

You put the purple flower into the container B.

>[3] put yellow flower in c
(first taking the yellow flower)
You picked up a yellow flower.

You put the yellow flower into the container C.

>[4] put white flower in d
(the container D)
(first taking the white flower)
You picked up a white flower.

You put the white flower into the container D.

You hear the sound of the gate opening
>[5] x gate
The puzzle gate is now open.

>remove red flower
You aren't wearing the red flower.

>take red flower from hands
You picked up a red flower.

You hear the sound of the gate closing.

>go e
Divine Cell 4
You see the gods sleeping

You can see a puzzle gate, Aphrodite and Hephaestus here.

* * *

>x gate
The gate is locked.

>test cad and then test gate
I only understood you as far as wanting to test that.

>test cad
(Testing.)

>[1] x dragon statue
The statue's mouth is closed.

>[2] put rock on dragon head
(first taking the rock)
You picked up a rock.

You put the rock on the dragon head.

The statue's mouth opened.

>[3] x dragon statue
 You see 6 tooth inside the statue's mouth.

>[4] take 6 dragon teeth
dragon tooth: You picked up a dragon tooth.
dragon tooth: You picked up a dragon tooth.
dragon tooth: You picked up a dragon tooth.
dragon tooth: You picked up a dragon tooth.
dragon tooth: You picked up a dragon tooth.
dragon tooth: You picked up a dragon tooth.

>[5] put 6 dragon teeth in the plate
dragon tooth: Done.
dragon tooth: Done.
dragon tooth: Done.
dragon tooth: Done.
dragon tooth: Done.
dragon tooth: Done.

The dragon teeth are syphoned into the altar and a compartment door opens, exposing 6 weights.

* * *

>x gate
The gate is now unlocked.

You open the dvgate.

>enter gate
Divine Cell 1
You can see a dvgate here.

* * *

>x gate
The gate is locked.

>x sign
The inscription reads: The key to passage lies from the lightest touch to the heaviest step.

>x walls
On the walls you see the legendary tale of Kadmos immortalized in 4 paintings. In the first, he bravely confronts the fearsome Dragon of Ismenus, guardian of Ares' sacred spring, slaying the beast with a rock on the head. In the second, you can see him sacrificing the dragon's parts to Athena. In the third one, guided by Athena's wisdom, he buries the dragon's teeth into the earth, from which arise the Spartoi-warriors born from the dragon's teeth, who then, in the fourth painting, battle amongst themselves. The paintings seem to be parts of a set, titled "The creation of Thebes".

>l
Palace of Kadmos
You can see a scale, a dragon statue, an altar, a sacrificial plate, some armchairs, a side table with a rock on top, some wall paintings, and a gate with a smaller scale on its right.

You can see a paintings, dragon statue, a Kadmea altar (on which is a sacrificial plate (empty)), a pan1, a pan2, a pan3, a pan4, a pan5, a pan6 and a scale here.

>x stone
You can't see any such thing.

>x rock
A medium-sized polished rock. Looks like limestone.

>x table
A hardwood side table.

There is a shiny rock on it.

>x armchairs
They're made of fine red silk. They look very soft.

>x statue
A small statue depicting a dragon. It is masterfully sculpted, with meticulous attention evident in every detail. Each scale is rendered with such precision that they appear almost lifelike, giving the dragon a sense of realism. 

The statue's mouth is closed.

>put rock on dragons head
You can't see any such thing.

>put rock on dragon head
(first taking the rock)
You picked up a rock.

You put the rock on the dragon head.

You hear the sound of stone grinding against stone. The dragon statue's mouth opened.

>x statue
A small statue depicting a dragon. It is masterfully sculpted, with meticulous attention evident in every detail. Each scale is rendered with such precision that they appear almost lifelike, giving the dragon a sense of realism. 

 You see 6 tooth inside the statue's mouth.

>take teeth
dragon tooth: You picked up a dragon tooth.
dragon tooth: You picked up a dragon tooth.
dragon tooth: You picked up a dragon tooth.
dragon tooth: You picked up a dragon tooth.
dragon tooth: You picked up a dragon tooth.
dragon tooth: You picked up a dragon tooth.

* * *

>x gnomon of the sundial
Some words carved on the gnomon read: At midday, let Apollo's light cast no shadow, and at midnight, let Artemis" glow guide the way. Only then shall the twins unveil the hidden path.

* * *

>x golden amphorae
You notice one amphora shine more than the others

>x amphora
Carved inside is a number Γ.

* * *

>x hand
You notice the number Α carved on its index finger.
It's not holding anything

>d
You swim through the waters.

* * *

>x hand
You notice the number Α carved on its index finger.
It's not holding anything

>put red flower in hand
You place the red flower in the statue's right hand.

>x
What do you want to examine?

>x hand
You notice the number Α carved on its index finger.
It's holding a red flower.

* * *

>x hands
You can't see any such thing.

>put flower in hands
Which do you mean, a red flower, a purple flower, a yellow flower or a white flower?

>put yellow flower in hands
You place the yellow flower in the statue's hands.

>x statue
The statue depicts a beautiful man. There is a sign on the statue's base. His hands look like they're holding something but there's nothing there. You notice the Greek number A on the statue.

>x hands
The statue is holding a 
*** Run-time problem P10: Since the hands is not allowed the property "flower colour", it is against the rules to try to use it.

<illegal flower colour> flower

* * *

>x hands
You can't see any such thing.

>put red flower in hand
You place the red flower in the statue's right hand.

>x hand
You notice the number Α carved on its index finger.
It's holding a hand.

>x statue
You find a marble sign on the statue's base. You can see he's holding statue in his right hand

* * *

>x hands
You can't see any such thing.

>put red flower in hands
You place the red flower in the statue's hands.

* * *

>x hearth
You see nothing special about the hearth.

* * *

>x heracles
Your husband, Heracles.

* * *

>x lake
It's a beautiful lake full of colourfull waterlilies.

>enter lake
You can't. All you can see is dirty water.

>d
You can't go down from here.

>open lake
You can't. All you can see is dirty water.

* * *

>take red flower
You picked up a red flower.

>x lake
Poseidon's Power flows through your vains. You can clearly see an underwather path. You wonder if it actually leads you where you should be.

You see nothing special about the lake.

>enter lake
You swim through the waters.

Divine Cell 4
You see the gods sleeping

You see a lake.

A heavy looking gate that seems to lead to the next room is on the eastern side of the garden, its view obstructed by vines and flowers.

You can also see Aphrodite and Hephaestus here.

* * *

>u
Secret Garden
You are in the Secret Garden

You see a lake.

A heavy looking gate that seems to lead to the next room is on the eastern side of the garden, its view obstructed by vines and flowers.

You find yourself before a flowerbed with intense red flowers...

a flowerbed with beautiful purple flowers...

a flowerbed with vibrant yellow flowers...

and a flowerbed with pretty white flowers.

In the garden you see a statue of a beautiful man.

You can also see a container B (empty), a container C (empty) and a container D (empty) here.

>throw red flower
Dropped.

>d
You can't go down from here.

* * *

>x lily
They smell good

>pick up lily
That's fixed in place.

* * *

>x nereida
J45--O-O-O.
 J45--O-O-O.

* * *

>x orange flower
The orange flowers have bright, fiery orange clusters of small, star-shaped flowers that stand out against their narrow, dark green leaves. The blossoms are arranged in flat-topped clusters, giving the plant a vibrant, bushy appearance. These are Butterfly Weed flowers. In the language of flowers, they signify a longing for release, letting go and parting.

>x sign
The inscription on it reads: 

 May our love root and grow eternally, even though I am but mortal.
 I am afraid I will pass from this world still holding on to the bittersweet memory of you.
 Even in our parting I will find solace in your scent.

>x red flower
The red flowers have vibrant, silky petals, coloured in deep red. Their petals surround a small, central cluster of tiny, golden yellow stamens, and are set against feathery, soft green leaves that are thin and finely divided, almost like delicate threads. These are Adonis flowers. In the language of flowers, they signify sorrowful memories and the transience of life.

>x purple flower
The purple flowers have tall, graceful stalks adorned with dense clusters of tiny, deep purple blossoms that cascade like flowing velvet. Their leaves are broad and slightly textured, with a rich green color that complements the vibrant blooms. These are Amaranthos flowers. In the language of flowers, they signify immortality, unfading love, and eternal beauty.

>inv
You are carrying nothing.

>investigate
In the Secret Garden you see a statue of a man, a lake, an olive tree and some flowerbeds with red, purple and orange flowers. In the perfume-making area there are some ceramic amphorae and a gate.

* * *

>x play
The troupe is now performing the Stymphalian Birds labour, the birds represented by a group of aerial performers who soared above the hall, their wings, crafted from layers of silken feathers, catching the light as they dipped and dived, their movements synchronized in a display of aerial acrobatics that have the audience cheering.

* * *

>x red flower
The red flower has vibrant, silky petals, coloured in deep red. The petals surround a small, central cluster of tiny, golden yellow stamens, and are set against feathery, soft green leaves that are thin and finely divided, almost like delicate threads.This is an Adonis Flower. In the language of flowers, it signifies sorrowful memories and the transience of life.

>x orange flower
This is an Butterfly Weed Flower.It is said to signify letting go.

* * *

>x red flowerbed
You can see some red flowers in this flowerbed.

In the red flowerbed are ten red flowers.

>pick up red flowers
red flower: You picked up a red flower.
red flower: You picked up a red flower.
red flower: You picked up a red flower.
red flower: You picked up a red flower.
red flower: You picked up a red flower.
red flower: You picked up a red flower.
red flower: You picked up a red flower.
red flower: You picked up a red flower.
red flower: You picked up a red flower.
red flower: That was the last red flower. There are no more in this garden.

>x red flowerbed
You picked up every red flower.

>l
Secret Garden
You are in the Secret Garden

You find yourself before a beautiful flowerbed with vibrant red flowers.

You find yourself before a beautiful flowerbed with vibrant purple flowers.

You find yourself before a beautiful flowerbed with vibrant yellow flowers.

You find yourself before a beautiful flowerbed with vibrant white flowers.

You can also see a puzzle gate, a statue, a container B (empty), a container C (empty) and a container D (empty) here.

* * *

>x red flowerbed
You can see some red flowers in this flowerbed.

In the red flowerbed are ten red flowers.

>take all red flowers from red flowerbed
red flower: You picked up a red flower.
red flower: You picked up a red flower.
red flower: You picked up a red flower.
red flower: You picked up a red flower.
red flower: You picked up a red flower.
red flower: You picked up a red flower.
red flower: You picked up a red flower.
red flower: You picked up a red flower.
red flower: You picked up a red flower.
red flower: You picked up a red flower.

>x red flowerbed
You picked up every red flower.

>take red flower from red flowerbed
You can't see any such thing.

* * *

>x ring 1
Its face shows blank.

>rotate ring 1
Nothing obvious happens.

>x ring 1
Its face shows blank.

* * *

>x ring1
Its face shows winter.

>rotate ring1
Now its face shows blank.

>x ring1
Its face shows blank.

>showme ring1
ring1 - ring
location: in the Poseidon's Temple
unlit, inedible, portable; singular-named, improper-named
description: none
initial appearance: none
ring face: blank
printed name: "ring1"
printed plural name: "rings"
indefinite article: none
list grouping key: none

>rotate ring1
Now its face shows spring.

>move ring 1
You can't see any such thing.

>move ring1
Nothing obvious happens.

>take ring1
You picked up a ring1.

>rotate ring1
Now its face shows summer.

>rotate ring1
Now its face shows fall.

>x ring1
Its face shows fall.

* * *

>x ring1
Its face shows winter.

>s
The nereides agree to take you to the sunken Temple.

Poseidon's Temple
You see a coloumn with 4 rotatable discs. The discs have 5 faces, 4 of them with a picture and one empty. The pictures are the same on each disc and they are in order: Budding olives and fresh green leaves, Green olives growing in size, with fuller leaves, Ripe, darkening olives ready for harvest, some fallen to the ground and Bare branches with a few remaining leaves, the tree in a state of dormancy. The faces towards the altar are all empty.

Altar.

Column that faces the altar.

On the column are Ring1, Ring 2, Ring3 and Ring 4.

>x ring1
On it you can see none.

* * *

>x ring1
Its face shows winter.

>x ring face of ring1
You can't see any such thing.

* * *

>x rings
They showcase sun and lunar markings, allowing you to use the dial to read the time day and night.

* * *

>x round flowerbed
You can't see any such thing.

* * *

>x shells
You find a big conch shell.

>take shell
That's fixed in place.

>x shell
It's cavity is very big. You can faintly see the number Β carved in it.

>put purple flower in shell
(first taking the purple flower)
You picked up a purple flower.

You put the purple flower into the conch shell.

>x shell
It's cavity is very big. You can faintly see the number Β carved in it.

In the conch shell is a purple flower.

* * *

>x sign
The inscription on it reads: 

 Letting go of your scent was the hardest thing I did.
 May our love root and grow eternally, even though I am but mortal.
 I will pass from this world still holding on to the bittersweet memory of you.

>x gate
The gate is tightly locked.

>x red flower
This is an Adonis Flower.

* * *

>x statue
The statue depicts a man with breathtaking beauty. His figure is carved with exquisite detail, and his chiseled features and graceful form are captured with masterful artistry. There is a longingness in his gaze, which falls on his raised right hand.

His right hand looks like it could be holding something but there's nothing there.
 
You can also see a marble sign on the statue's base.

>enter statue
It seems like you might be missing two keys.

It seems to be locked.

(first opening the statue of artemis)
It seems like you might be missing two keys.

It seems to be locked.

>enter door
It seems like you might be missing two keys.

It seems to be locked.

(first opening the statue of artemis)
It seems like you might be missing two keys.

It seems to be locked.

>showme enter
There seems to be no such object anywhere in the model world.

* * *

>x statue
The statue depicts a man with breathtaking beauty. His figure is carved with exquisite detail, and his chiseled features and graceful form are captured with masterful artistry. There is a longingness in his gaze, which falls on his raised right hand.

His right hand looks like it could be holding something but there's nothing there.
 
You can also see a marble sign on the statue's base.

>put aria in right hand
You place the aria in the statue's right hand.

>x statue
You find a marble sign on the statue's base. You can see he's holding an aria in his right hand

* * *

>x statue
The statue depicts a man with breathtaking beauty. His figure is carved with exquisite detail, and his chiseled features and graceful form are captured with masterful artistry. There is a longingness in his gaze, which falls on his raised right hand.

His right hand looks like it could be holding something but there's nothing there.
 
You can also see a marble sign on the statue's base.

>put rock on dragon head
(first taking the rock)
You picked up a rock.

You put the rock on the dragon head.

The statue's mouth opened.

>x statue
You see 5 tooth inside the statue's mouth.

>take 3 teeth
dragon tooth: You picked up a dragon tooth.
dragon tooth: You picked up a dragon tooth.
dragon tooth: You picked up a dragon tooth.

>take rock
You picked up a rock.

The statue's mouth closed

>x statue
The statue's mouth is closed.

* * *

>x statue
The statue depicts a man with breathtaking beauty. His figure is carved with exquisite detail, and his chiseled features and graceful form are captured with masterful artistry. There is a longingness in his gaze, which falls on his raised right hand.

His right hand looks like it could be holding something but there's nothing there.
 
You can also see a marble sign on the statue's base.

>showme dragon mouth
dragon mouth - open container
    dragon tooth - dragon tooth
    dragon tooth - dragon tooth
    dragon tooth - dragon tooth
    dragon tooth - dragon tooth
    dragon tooth - dragon tooth
location: part of dragon statue in Cadmea
unlit, inedible, portable; opaque, open, openable, unlocked; singular-named, improper-named
description: none
initial appearance: "dragon mouth."
carrying capacity: 100
printed name: "dragon mouth"
printed plural name: "containers"
indefinite article: none
list grouping key: none

>take 1 dragon tooth
You picked up a dragon tooth.

>x dragon mouth
In the dragon mouth are four dragon teeth.

>take 3 dragon teeth
dragon tooth: You picked up a dragon tooth.
dragon tooth: You picked up a dragon tooth.
dragon tooth: You picked up a dragon tooth.

* * *

>x statue
The statue depicts a man with breathtaking beauty. His figure is carved with exquisite detail, and his chiseled features and graceful form are captured with masterful artistry. There is a longingness in his gaze, which falls on his raised right hand.

His right hand looks like it could be holding something but there's nothing there.
 
You can also see a marble sign on the statue's base.

>showme statue
(dragon statue)
dragon statue - thing
    dragon head (part of dragon statue) - supporter
    dragon mouth (part of dragon statue) - open container
        5 dragon teeth
location: in Cadmea
unlit, inedible, fixed in place; singular-named, proper-named
description: none
initial appearance: none
printed name: "dragon statue"
printed plural name: none
indefinite article: none
list grouping key: none

* * *

>x statue
The statue depicts a man with breathtaking beauty. His figure is carved with exquisite detail, and his chiseled features and graceful form are captured with masterful artistry. There is a longingness in his gaze, which falls on his raised right hand.

His right hand looks like it could be holding something but there's nothing there.
 
You can also see a marble sign on the statue's base.

>take red flower
You picked up a red flower.

>put red flower on arms
Putting things on the arms would achieve nothing.

>put red flower in arms
You put the red flower into the arms.

* * *

>x statue
The statue depicts a man with breathtaking beauty. His figure is carved with exquisite detail, and his chiseled features and graceful form are captured with masterful artistry. There is a longingness in his gaze, which falls on his raised right hand.

His right hand looks like it could be holding something but there's nothing there.
 
You can also see a marble sign on the statue's base.

>x hand
The hand is empty

>x right hand
The hand is empty

* * *

>x statue
The statue depicts a man with breathtaking beauty. His figure is carved with exquisite detail, and his chiseled features and graceful form are captured with masterful artistry. There is a longingness in his gaze, which falls on his raised right hand.

His right hand looks like it could be holding something but there's nothing there.
 
You can also see a marble sign on the statue's base.

>x hands
The hands are empty

>put red flower in hands
You place the red flower in the statue's hands.

>x hands
The statue is holding a 
*** Run-time problem P10: Since the hands is not allowed the property "flower colour", it is against the rules to try to use it.

<illegal flower colour> flower

* * *

>x statue
The statue depicts a man with breathtaking beauty. His figure is carved with exquisite detail, and his chiseled features and graceful form are captured with masterful artistry. There is a longingness in his gaze, which falls on his raised right hand.

His right hand looks like it could be holding something but there's nothing there.
 
You can also see a marble sign on the statue's base.

>x sign
The inscription on it reads: 

 Letting go of your scent was the hardest thing I did.
 May our love root and grow eternally, even though I am but mortal.
 I will pass from this world still holding on to the bittersweet memory of you.

>x statue
The statue depicts a man with breathtaking beauty. His figure is carved with exquisite detail, and his chiseled features and graceful form are captured with masterful artistry. There is a longingness in his gaze, which falls on his raised right hand.

His right hand looks like it could be holding something but there's nothing there.

>l
Secret Garden
You find yourself in an enchanted underground garden, where magic seems to pulse from every corner. The air is thick with the intoxicating scent of flowers, each blossom radiating a soft, ethereal glow. Though deep beneath the earth, the space is bathed in a gentle, divine light radiating from the plants themselves, complemented by the soft flicker of the candles lining the paths, their wax bodies somehow untouched by time or flame. Despite the absence of any other life, the garden feels alive, giving the impression it exists in a suspended moment between the past and present.

As one steps through the entrance, their eyes would be immediately drawn to a statue of an incomprehensibly beautiful man, poised on a marble base. His right hand is raised, his gaze fixed intently on it, as if beholding some unseen object. Behind the statue lies a serene natural lake, with delicate pink and white lilies gently laying on its surface. On the other side of the water, a majestic olive tree stands, ancient and hollowed by the passage of centuries, its gnarled bark a testament to its age. Some round flower beds bursting with vibrant red, purple, and orange flowers are encircling the lake and the tree.

On the eastern side of the room, separated by a couple of steps decorated with flowers and candles, there is a secluded perfume-making area. Here, counters are crowded with the tools and equipment necessary for crafting fragrant elixirs, while golden amphorae are stored beneath, likely to store finished scents. The area leads to a gate covered in vines and flowers, making passage through it impossible.

>x sign
The inscription on it reads: 

 Letting go of your scent was the hardest thing I did.
 May our love root and grow eternally, even though I am but mortal.
 I will pass from this world still holding on to the bittersweet memory of you.

* * *

>x statue
The statue depicts a man with breathtaking beauty. His figure is carved with exquisite detail, and his chiseled features and graceful form are captured with masterful artistry. There is a longingness in his gaze, which falls on his raised right hand.

His right hand looks like it could be holding something but there's nothing there.
 
You can also see a marble sign on the statue's base.

>x sundial
The dial is designed with two separate rings encircling its plate, one with sun and one with lunar engravings, allowing you to read the time day and night. You also see on the gnomon an inscription engraved and gilded in gold that says: At midday, let Apollo's light cast no shadow, and at midnight, let Artemis" glow guide the way. Only then shall the twins unveil the hidden path.

Judging by the gnomon's shadow and the sun markings, the time is nine o'clock.

>x altar
The altar of Artemis.

>wait until midday
It is twelve o'clock now.

At twelve o'clock  you hear the click of a latch releasing and a sun hatch opening coming from the dial.

I beg your pardon?

>x sun hatch
The sun hatch is open. Inside you can see a sun key.

* * *

>take sun key
You picked up a sun key.

>x sun key
The head of the key is shapped like a sun with curvy rays. Its colour is a bright gold.

>wait until midnight
At ten past twelve you hear the sound of the sun hatch closing and the click of a latch locking coming from the dial.

It is twelve o'clock now.

At twelve o'clock you hear the click of a latch releasing and a moon hatch opening coming from the dial.

>x moon
Which do you mean, the moon lock, the moon pocket or the moon key?

>x moon hatch
The moon hatch is open. Inside you can see a moon key.

>x moon key
The head of the key is shapped like a cresent moon. Its colour is a warm ivory.

>take moon key
You picked up a moon key.

* * *

>put sun key in sun lock
You put the sun key in the sun-shapped lock.

You put the sun key into the sun lock.

You hear the sound of a locking mechanism unlocking.

>take keys
You can't see any such thing.

>take sun key
You picked up a sun key.

You hear the sound of the locking mechanism locking.

>unlock sun lock
You put the sun key in the sun-shapped lock.

You hear the sound of a locking mechanism unlocking.

>lock sun lock
What do you want to lock the sun lock with?

>lock sun lock with sun key
(first taking the sun key)
You picked up a sun key.

That doesn't seem to be something you can lock.

You hear the sound of the locking mechanism locking.

>unlock sun lock with sun key
You put the sun key in the sun-shapped lock.

At ten past twelve you hear the sound of the moon hatch closing and the click of a latch locking coming from the dial.

You hear the sound of a locking mechanism unlocking.

>open moon lock with moon key
(first taking the moon key)
You picked up a moon key.

You put the moon key in the moon-shapped lock.

>l
Inside the Temple of the Aulidean Artemis you can see a sundial, the statue of Artemis and her sacrificial altar.

>l
Temple of the Aulidean Artemis
You step into the sacred temple of Aulidean Artemis. The temple is empty and abandoned by the priestesses, following Kronos' seizure of power, as expected, unfortunately.

As you pass through the pronaos, your eyes are drawn to the moonlight cascading down from the open ceiling, illuminating an imposing sundial made of pearly white marble that stands at the center of the chamber. The moon's rays cross paths with the dial's gnomon, casting a shadow that marks the hour.

Entering the naos, the most divine part of the temple, you find yourself in the presence of the graceful golden statue of Artemis. Your sister stands tall and proud, her form aglow with a divine radiance that speaks of her unyielding strength and purity. In her left hand, she holds the antlers of a noble deer, symbolizing her dominion over the wild, while her right hand grips her bow, ever ready to protect those who dwell under her watchful eye. A quiver, filled with finely crafted arrows, rests upon her back, the tools of the huntress who lets no prey escape.

Directly in front of her statue is the altar of Artemis, a place where mortals would lay their offerings not long ago, hoping to earn her favor.

>x statue
The statue feels wobbly. Maybe you could try pushing it...

* * *

>d
You take the stairs that lead under the temple.

Divine Cell of Artemis & Apollo
You can see a Goddess Artemis and a God Apollo here.

>u
Temple of the Aulidean Artemis
You step into the sacred temple of Aulidean Artemis. The temple is empty and abandoned by the priestesses, following Kronos' seizure of power, as expected, unfortunately.

As you pass through the pronaos, your eyes are drawn to the moonlight cascading down from the open ceiling, illuminating an imposing sundial made of pearly white marble that stands at the center of the chamber. The moon's rays cross paths with the dial's gnomon, casting a shadow that marks the hour.

Entering the naos, the most divine part of the temple, you find yourself in the presence of the graceful golden statue of Artemis. Your sister stands tall and proud, her form aglow with a divine radiance that speaks of her unyielding strength and purity. In her left hand, she holds the antlers of a noble deer, symbolizing her dominion over the wild, while her right hand grips her bow, ever ready to protect those who dwell under her watchful eye. A quiver, filled with finely crafted arrows, rests upon her back, the tools of the huntress who lets no prey escape.

Directly in front of her statue is the altar of Artemis, a place where mortals would lay their offerings not long ago, hoping to earn her favor.

>x statue
You can see some stairs leading downstairs.

>close statue
You close the statue of artemis.

>l
Temple of the Aulidean Artemis
You step into the sacred temple of Aulidean Artemis. The temple is empty and abandoned by the priestesses, following Kronos' seizure of power, as expected, unfortunately.

As you pass through the pronaos, your eyes are drawn to the moonlight cascading down from the open ceiling, illuminating an imposing sundial made of pearly white marble that stands at the center of the chamber. The moon's rays cross paths with the dial's gnomon, casting a shadow that marks the hour.

Entering the naos, the most divine part of the temple, you find yourself in the presence of the graceful golden statue of Artemis. Your sister stands tall and proud, her form aglow with a divine radiance that speaks of her unyielding strength and purity. In her left hand, she holds the antlers of a noble deer, symbolizing her dominion over the wild, while her right hand grips her bow, ever ready to protect those who dwell under her watchful eye. A quiver, filled with finely crafted arrows, rests upon her back, the tools of the huntress who lets no prey escape.

Directly in front of her statue is the altar of Artemis, a place where mortals would lay their offerings not long ago, hoping to earn her favor.

>d
You take the stairs that lead under the temple.

(first opening the statue of artemis)
You push the statue away and you reveal some stairs leading under the temple.

Divine Cell of Artemis & Apollo
You can see a Goddess Artemis and a God Apollo here.

>l
Divine Cell of Artemis & Apollo
You can see a Goddess Artemis and a God Apollo here.

>u
Temple of the Aulidean Artemis
You step into the sacred temple of Aulidean Artemis. The temple is empty and abandoned by the priestesses, following Kronos' seizure of power, as expected, unfortunately.

As you pass through the pronaos, your eyes are drawn to the moonlight cascading down from the open ceiling, illuminating an imposing sundial made of pearly white marble that stands at the center of the chamber. The moon's rays cross paths with the dial's gnomon, casting a shadow that marks the hour.

Entering the naos, the most divine part of the temple, you find yourself in the presence of the graceful golden statue of Artemis. Your sister stands tall and proud, her form aglow with a divine radiance that speaks of her unyielding strength and purity. In her left hand, she holds the antlers of a noble deer, symbolizing her dominion over the wild, while her right hand grips her bow, ever ready to protect those who dwell under her watchful eye. A quiver, filled with finely crafted arrows, rests upon her back, the tools of the huntress who lets no prey escape.

Directly in front of her statue is the altar of Artemis, a place where mortals would lay their offerings not long ago, hoping to earn her favor.

>open statue
You can see some stairs leading downstairs.

>take sun key
You picked up a sun key.

You hear the sound of the locking mechanism locking, but the door is already open.

>d
You can't go that way.

>open statue
You can see some stairs leading downstairs.

* * *

>x sundial
You notice it has both sundial and moondial marks, so you can tell the time both with the help of the sun and the moon. You also see some words carved on its gnomon: At midday, let Apollo's light cast no shadow, and at midnight, let Artemis" glow guide the way. Only then shall the twins unveil the hidden path.

Judging by the gnomon's shadow and the sun markings, the time is nine o'clock.

>wait
Time passes.

>l
Temple of the Aulidean Artemis
You can see one sun lock and one moon lock on the door.

You can also see a sundial here.

>x sundial
Judging by the shadow and the markings, the time is ten past nine.

>showme sun pocket
sun pocket - closed container
    sun key
location: part of the sundial in the Temple of the Aulidean Artemis
unlit, inedible, fixed in place; opaque, closed, unopenable, unlocked; singular-named, improper-named
description: none
initial appearance: none
carrying capacity: 100
printed name: "sun pocket"
printed plural name: "containers"
indefinite article: none
list grouping key: none

* * *

>x sundial
You notice it has both sundial and moondial marks, so you can tell the time both with the help of the sun and the moon. You also see some words carved on its gnomon: At midday, let Apollo's light cast no shadow, and at midnight, let Artemis" glow guide the way. Only then shall the twins unveil the hidden path.

Judging by the gnomon's shadow and the sun markings, the time is nine o'clock.

>wait until 12 pm
It is  12:00 pm now.

You notice that the sun pocket open.

You hear the sound of the sun pocket opening.

* * *

>x sundial
You notice it has both sundial and moondial marks, so you can tell the time both with the help of the sun and the moon. You also see some words carved on its gnomon: At midday, let Apollo's light cast no shadow, and at midnight, let Artemis" glow guide the way. Only then shall the twins unveil the hidden path.

Judging by the gnomon's shadow and the sun markings, the time is nine o'clock.

>wait until twelve o' clock
I only understood you as far as wanting to wait.

>wait
Time passes.

>x sundial
Judging by the shadow and the markings, the time is nine o'clock.

>wait 5 times
I only understood you as far as wanting to wait.

>wait
Time passes.

* * *

>x sundial
Judging by the shadow and the markings, the time is nine o'clock.

>x sundial
Judging by the shadow and the markings, the time is ten past nine.

* * *

>x sundial
You notice it has both sundial and moondial marks, so you can tell the time both with the help of the sun and the moon. You also see some words carved on its gnomon: At midday, let Apollo's light cast no shadow, and at midnight, let Artemis" glow guide the way. Only then shall the twins unveil the hidden path.

Judging by the gnomon's shadow and the sun markings, the time is nine o'clock.

>x sundial
The words carved on the gnomon read: At midday, let Apollo's light cast no shadow, and at midnight, let Artemis" glow guide the way. Only then shall the twins unveil the hidden path.

Judging by the gnomon's shadow and the sun markings, the time is nine o'clock.

>wait until 9 pm
At twelve o'clock you hear the sound of the sun pocket opening.

At ten past twelve you hear the sound of the sun pocket closing.

It is nine o'clock now.

>x sundial
The words carved on the gnomon read: At midday, let Apollo's light cast no shadow, and at midnight, let Artemis" glow guide the way. Only then shall the twins unveil the hidden path.

Judging by the gnomon's shadow and the moon markings, the time is nine o'clock.

>x moondial
The words carved on the gnomon read: At midday, let Apollo's light cast no shadow, and at midnight, let Artemis" glow guide the way. Only then shall the twins unveil the hidden path.

Judging by the gnomon's shadow and the moon markings, the time is nine o'clock.

* * *

>x sundial
The words carved on the gnomon read: At midday, let Apollo's light cast no shadow, and at midnight, let Artemis" glow guide the way. Only then shall the twins unveil the hidden path.

Judging by the gnomon's shadow and the sun markings, the time is nine o'clock.

>x sundial
Judging by the shadow and the markings, the time is two minutes past nine.

>x sundial
Judging by the shadow and the markings, the time is three minutes past nine.

>x sundial
Judging by the shadow and the markings, the time is four minutes past nine.

>x sundial
Judging by the shadow and the markings, the time is five past nine.

You notice that the sun pocket is open.

You hear the sound of the sun pocket opening.

>x sundial
Judging by the shadow and the markings, the time is six minutes past nine.

You notice that the sun pocket is open.

>x sundial
Judging by the shadow and the markings, the time is seven minutes past nine.

You notice that the sun pocket is open.

>x sundial
Judging by the shadow and the markings, the time is eight minutes past nine.

You notice that the sun pocket is open.

>x sundial
Judging by the shadow and the markings, the time is nine minutes past nine.

You notice that the sun pocket is open.

>x sundial
Judging by the shadow and the markings, the time is ten past nine.

>showme sundial
sundial - thing
    sun pocket (part of sundial) - open container
        sun key
    moon pocket (part of sundial) - closed container
        moon key
location: in the Temple of the Aulidean Artemis
unlit, inedible, fixed in place; singular-named, improper-named
description: none
initial appearance: none
printed name: "sundial"
printed plural name: none
indefinite article: none
list grouping key: none

>x sundial
Judging by the shadow and the markings, the time is eleven minutes past nine.

>x sundial
Judging by the shadow and the markings, the time is twelve minutes past nine.

* * *

>x sundial
Judging by the shadow and the markings, the time is ten past nine.

>x sundial
Judging by the shadow and the markings, the time is eleven minutes past nine.

You hear the sound of the sun pocket closing.

>showme sun pocket
sun pocket - open container
    sun key
location: part of the sundial in the Temple of the Aulidean Artemis
unlit, inedible, fixed in place; opaque, open, unopenable, unlocked; singular-named, improper-named
description: none
initial appearance: none
carrying capacity: 100
printed name: "sun pocket"
printed plural name: "containers"
indefinite article: none
list grouping key: none

>x sundial
Judging by the shadow and the markings, the time is twelve minutes past nine.

>x sundial
Judging by the shadow and the markings, the time is thirteen minutes past nine.

>x sundial
Judging by the shadow and the markings, the time is fourteen minutes past nine.

>x sundial
Judging by the shadow and the markings, the time is quarter past nine.

>x sundial
Judging by the shadow and the markings, the time is sixteen minutes past nine.

>x sundial
Judging by the shadow and the markings, the time is seventeen minutes past nine.

>showme sun poclet
There seems to be no such object anywhere in the model world.

>showme sun pocket
sun pocket - closed container
    sun key
location: part of the sundial in the Temple of the Aulidean Artemis
unlit, inedible, fixed in place; opaque, closed, unopenable, unlocked; singular-named, improper-named
description: none
initial appearance: none
carrying capacity: 100
printed name: "sun pocket"
printed plural name: "containers"
indefinite article: none
list grouping key: none

* * *

>x sundial
Judging by the shadow and the markings, the time is eleven minutes past nine.

You hear the sound of the sun pocket closing.

>showme sunpocket
There seems to be no such object anywhere in the model world.

>showme sun pocket
sun pocket - closed container
    sun key
location: part of the sundial in the Temple of the Aulidean Artemis
unlit, inedible, fixed in place; opaque, closed, unopenable, unlocked; singular-named, improper-named
description: none
initial appearance: none
carrying capacity: 100
printed name: "sun pocket"
printed plural name: "containers"
indefinite article: none
list grouping key: none

* * *

>x third ring
Its face shows blank.

>rotate third ring
Nothing obvious happens.

>rotate third ring clockwise
Now its face shows winter.

>rotate third ring anticlockwise
Now its face shows blank.

>rotate third ring anticlockwise
Now its face shows spring.

>rotate third ring anticlockwise
Now its face shows summer.

>rotate third ring clockwise
Now its face shows spring.

>rotate top ring to the left
I only understood you as far as wanting to rotate top ring.

>rotate clockwise the top ring
Now its face shows winter.

>rotate the top ring counterclockwise
Now its face shows blank.

>go in door
(first opening the temple door)
It isn't something you can open.

* * *

>x torch
(the portable torch)
A portable torch.

>x portable torch
A portable torch.

>x scrolls
You see two papyrus scrolls and one parchment scroll. One papyrus scroll is empty.

>x papyrus scrolls
I only understood you as far as wanting to examine the papyrus scroll.

>x scrolls
You see two papyrus scrolls and one parchment scroll. One papyrus scroll is empty.

* * *

>x torch1
The torch1 is currently switched off.

* * *

>x torches
The first torch is unlit.
 The second torch is unlit.
 The third torch is unlit.
 The fourth torch is unlit.
 The fifth torch is unlit.
 The sixth torch is unlit.
 The seventh torch is unlit.
 The eighth torch is unlit.
 The ninth torch is unlit.
 The tenth torch is unlit.
 The eleventh torch is unlit.
 The twelfth torch is unlit.
 The thirteenth torch is unlit.
 The fourteenth torch is unlit.
 The fifteenth torch is unlit.
 The sixteenth torch is unlit.

>light the 3rd and 4th torch
You can't see any such thing.

>light the 3rd torch
You picked up the portable torch.

You lighted the third torch using the portable torch.

>light the 6th torch
You lighted the sixth torch using the portable torch.

>x torches
The first torch is unlit.
 The second torch is unlit.
 The third torch is lit.
 The fourth torch is unlit.
 The fifth torch is unlit.
 The sixth torch is lit.
 The seventh torch is unlit.
 The eighth torch is unlit.
 The ninth torch is unlit.
 The tenth torch is unlit.
 The eleventh torch is unlit.
 The twelfth torch is unlit.
 The thirteenth torch is unlit.
 The fourteenth torch is unlit.
 The fifteenth torch is unlit.
 The sixteenth torch is unlit.

* * *

>x torches
The first torch is unlit.
 The second torch is unlit.
 The third torch is unlit.
 The fourth torch is unlit.
 The fifth torch is unlit.
 The sixth torch is unlit.
 The seventh torch is unlit.
 The eighth torch is unlit.
 The ninth torch is unlit.
 The tenth torch is unlit.
 The eleventh torch is unlit.
 The twelfth torch is unlit.
 The thirteenth torch is unlit.
 The fourteenth torch is unlit.
 The fifteenth torch is unlit.
 The sixteenth torch is unlit.

>x flames
You can't see any such thing.

>look torches
You can't use multiple objects with that verb.

* * *

>x trapdoor
You can't see such thing.

* * *

>open trapdoor
You can't see such thing.

>enter trapdoor
You can't see such thing.

>smell trapdoor
You can't see such thing.

>move trapdoor
You can't see such thing.

>move table
You put all your strength into pushing the table off the carpet- and you manage it!

>move table
You pushed the table on the carpet again.

>move table
You pushed the table off the carpet.

>move chairs
You push the chairs off the carpet.

>move chair
You push the chairs on the carpet again.

>move carpet
You can't pull the carpet if there are things on top of it.

* * *

>move chairs
You push the chairs off the carpet.

>move carpet
You pulled the carpet. 

By pulling the carpet out of the way you revealed a trapdoor.

>x trapdoor
The trapdoor is locked now.

>g
The trapdoor is locked now.

>showme trapdoor
trapdoor - locked door
location: in Prytaneion
unlit, inedible, fixed in place, scenery; closed, openable, lockable, locked; singular-named, improper-named; interactable
description: none
initial appearance: none
smell: neutral
leading-through destination: <routine 241369>
printed name: "trapdoor"
printed plural name: "doors"
indefinite article: none
list grouping key: none

>x doors
The trapdoor is locked now.

* * *

>x tree
(the weeping willow)
It's a majestic weeping willow tree. You notice it has a cavity in the middle.

>x tree
(the hollow tree)
It's a majestic weeping willow tree. You notice it has a cavity in the middle.

* * *

>x vines
They're just some vines

>x gate
The puzzle gate is tightly closed.

* * *

>x water lily
They smell smells

* * *

>x wax tablet
_  _ _ _ _  _ _ _ _ _ _  _ _ _ _  _ _ _ _ _  _ _. _ _ _ _ _  _ _  _ _ _ _ _  _ _  _ _ _  _ _ _ _. 

G KSXO SYFJKOQ JOAH IYNOQ HO. MQGYT HO ERFUO JF JKO WGQO.